MODE 2
SIZE 11/70
LIMIT 0/31
COLOR LIMIT 4
STARS 1000/2000/3500
POWERUPS 1/1/0/0
1 1 3 1 1 12 1 1 3 1 1
1 3 1 1 0 0 1 1 3 1 0
1 3 1 0 0 8 0 0 1 3 1
3 1 0 20 20 20 20 0 1 3 0
1 0 0 20 1 14 1 20 0 0 1
4 0 0 20 20 20 20 0 0 4 0
0 4 3 3 5 3 5 3 3 4 0
2 4 3 5 20 20 5 3 4 2 0
4 2 2 5 3 3 3 5 2 2 4
4 4 4 4 3 3 4 4 4 4 0
0 0 17 17 0 15 0 17 17 0 0
0 0 0 1 1 1 1 0 0 0 0
2 2 2 2 0 0 0 2 2 2 2
1 1 1 18 1 1 18 1 1 1 0
0 2 2 0 0 18 0 0 2 2 0
3 2 3 5 5 5 5 3 2 3 0
3 3 3 3 0 19 0 3 3 3 3
0 7 7 7 5 5 7 7 7 0 0
0 0 0 7 7 0 7 7 0 0 0
0 0 0 7 7 7 7 0 0 0 0
0 0 0 0 0 0 0 0 0 0 0
0 0 0 0 0 0 0 0 0 0 0
0 0 0 0 0 0 0 0 0 0 0
0 0 0 0 0 0 0 0 0 0 0
0 0 0 0 0 0 0 0 0 0 0
0 0 0 0 0 0 0 0 0 0 0
0 0 0 0 0 0 0 0 0 0 0
0 0 0 0 0 0 0 0 0 0 0
0 0 0 0 0 0 0 0 0 0 0
0 0 0 0 0 0 0 0 0 0 0
0 0 0 0 0 0 0 0 0 0 0
0 0 0 0 0 0 0 0 0 0 0
0 0 0 0 0 0 0 0 0 0 0
0 0 0 0 0 0 0 0 0 0 0
0 0 0 0 0 0 0 0 0 0 0
0 0 0 0 0 0 0 0 0 0 0
0 0 0 0 0 0 0 0 0 0 0
0 0 0 0 0 0 0 0 0 0 0
0 0 0 0 0 0 0 0 0 0 0
0 0 0 0 0 0 0 0 0 0 0
0 0 0 0 0 0 0 0 0 0 0
0 0 0 0 0 0 0 0 0 0 0
0 0 0 0 0 0 0 0 0 0 0
0 0 0 0 0 0 0 0 0 0 0
0 0 0 0 0 0 0 0 0 0 0
0 0 0 0 0 0 0 0 0 0 0
0 0 0 0 0 0 0 0 0 0 0
0 0 0 0 0 0 0 0 0 0 0
0 0 0 0 0 0 0 0 0 0 0
0 0 0 0 0 0 0 0 0 0 0
0 0 0 0 0 0 0 0 0 0 0
0 0 0 0 0 0 0 0 0 0 0
0 0 0 0 0 0 0 0 0 0 0
0 0 0 0 0 0 0 0 0 0 0
0 0 0 0 0 0 0 0 0 0 0
0 0 0 0 0 0 0 0 0 0 0
0 0 0 0 0 0 0 0 0 0 0
0 0 0 0 0 0 0 0 0 0 0
0 0 0 0 0 0 0 0 0 0 0
0 0 0 0 0 0 0 0 0 0 0
0 0 0 0 0 0 0 0 0 0 0
0 0 0 0 0 0 0 0 0 0 0
0 0 0 0 0 0 0 0 0 0 0
0 0 0 0 0 0 0 0 0 0 0
0 0 0 0 0 0 0 0 0 0 0
0 0 0 0 0 0 0 0 0 0 0
0 0 0 0 0 0 0 0 0 0 0
0 0 0 0 0 0 0 0 0 0 0
0 0 0 0 0 0 0 0 0 0 0
0 0 0 0 0 0 0 0 0 0 0