MODE 2
SIZE 11/70
LIMIT 0/40
COLOR LIMIT 4
STARS 1500/3000/5200
POWERUPS 1/1/1/1
1 1 1 3 3 3 3 3 1 1 1
3 5 5 0 6 4 0 5 5 3 0
1 7 7 7 0 16 0 7 7 7 1
3 13 5 5 6 4 5 5 13 3 0
1 7 7 7 0 10 0 7 7 7 1
3 5 5 0 6 4 0 5 5 3 0
1 7 7 7 0 20 0 7 7 7 1
3 8 5 5 6 4 5 5 8 3 0
1 7 7 7 0 8 0 7 7 7 1
3 5 5 0 6 4 0 5 5 3 0
1 7 7 7 0 20 0 7 7 7 1
3 14 5 5 6 4 5 5 14 3 0
1 7 7 7 0 20 0 7 7 7 1
3 5 5 0 6 4 0 5 5 3 0
1 7 7 7 20 20 20 7 7 7 1
3 0 5 5 6 4 5 5 0 3 0
1 7 7 7 20 20 20 7 7 7 1
3 5 5 0 6 4 0 5 5 3 0
1 7 7 7 0 15 0 7 7 7 1
3 0 5 5 6 4 5 5 0 3 0
1 7 7 7 0 0 0 7 7 7 1
0 0 0 0 0 0 0 0 0 0 0
0 0 0 0 0 0 0 0 0 0 0
0 0 0 0 0 0 0 0 0 0 0
0 0 0 0 0 0 0 0 0 0 0
0 0 0 0 0 0 0 0 0 0 0
0 0 0 0 0 0 0 0 0 0 0
0 0 0 0 0 0 0 0 0 0 0
0 0 0 0 0 0 0 0 0 0 0
0 0 0 0 0 0 0 0 0 0 0
0 0 0 0 0 0 0 0 0 0 0
0 0 0 0 0 0 0 0 0 0 0
0 0 0 0 0 0 0 0 0 0 0
0 0 0 0 0 0 0 0 0 0 0
0 0 0 0 0 0 0 0 0 0 0
0 0 0 0 0 0 0 0 0 0 0
0 0 0 0 0 0 0 0 0 0 0
0 0 0 0 0 0 0 0 0 0 0
0 0 0 0 0 0 0 0 0 0 0
0 0 0 0 0 0 0 0 0 0 0
0 0 0 0 0 0 0 0 0 0 0
0 0 0 0 0 0 0 0 0 0 0
0 0 0 0 0 0 0 0 0 0 0
0 0 0 0 0 0 0 0 0 0 0
0 0 0 0 0 0 0 0 0 0 0
0 0 0 0 0 0 0 0 0 0 0
0 0 0 0 0 0 0 0 0 0 0
0 0 0 0 0 0 0 0 0 0 0
0 0 0 0 0 0 0 0 0 0 0
0 0 0 0 0 0 0 0 0 0 0
0 0 0 0 0 0 0 0 0 0 0
0 0 0 0 0 0 0 0 0 0 0
0 0 0 0 0 0 0 0 0 0 0
0 0 0 0 0 0 0 0 0 0 0
0 0 0 0 0 0 0 0 0 0 0
0 0 0 0 0 0 0 0 0 0 0
0 0 0 0 0 0 0 0 0 0 0
0 0 0 0 0 0 0 0 0 0 0
0 0 0 0 0 0 0 0 0 0 0
0 0 0 0 0 0 0 0 0 0 0
0 0 0 0 0 0 0 0 0 0 0
0 0 0 0 0 0 0 0 0 0 0
0 0 0 0 0 0 0 0 0 0 0
0 0 0 0 0 0 0 0 0 0 0
0 0 0 0 0 0 0 0 0 0 0
0 0 0 0 0 0 0 0 0 0 0
0 0 0 0 0 0 0 0 0 0 0
0 0 0 0 0 0 0 0 0 0 0
0 0 0 0 0 0 0 0 0 0 0
0 0 0 0 0 0 0 0 0 0 0