MODE 2
SIZE 11/70
LIMIT 0/20
COLOR LIMIT 4
STARS 1000/2500/4000
POWERUPS 0/0/0/0
0 3 0 5 0 20 20 0 0 7 7
3 3 5 5 7 1 7 7 3 7 0
0 9 7 15 7 1 1 7 3 3 0
0 7 0 0 3 8 0 0 9 7 0
0 0 1 7 3 3 20 20 7 5 0
0 1 1 0 9 0 0 0 5 5 0
0 3 8 0 0 5 7 7 3 15 0
3 3 0 0 5 5 7 3 3 0 0
0 7 1 0 0 15 20 0 9 7 0
0 1 1 7 3 0 20 0 7 3 0
0 0 8 7 3 3 7 1 7 3 3
7 7 0 20 9 7 1 1 20 9 0
0 3 0 20 0 0 0 8 0 0 0
3 3 20 0 0 0 7 3 0 0 0
0 9 7 7 1 7 7 3 3 7 0
0 7 7 1 1 5 7 9 7 0 0
0 0 7 3 8 5 5 7 7 0 0
0 0 3 3 7 15 7 7 0 0 0
0 0 7 9 7 7 7 7 7 1 0
0 5 7 7 7 0 7 7 1 1 0
0 5 5 7 7 0 0 7 7 8 0
0 15 7 7 0 0 0 7 7 7 0
0 7 7 7 0 0 0 0 7 7 7
0 0 0 0 0 0 0 0 0 0 0
0 0 0 0 0 0 0 0 0 0 0
0 0 0 0 0 0 0 0 0 0 0
0 0 0 0 0 0 0 0 0 0 0
0 0 0 0 0 0 0 0 0 0 0
0 0 0 0 0 0 0 0 0 0 0
0 0 0 0 0 0 0 0 0 0 0
0 0 0 0 0 0 0 0 0 0 0
0 0 0 0 0 0 0 0 0 0 0
0 0 0 0 0 0 0 0 0 0 0
0 0 0 0 0 0 0 0 0 0 0
0 0 0 0 0 0 0 0 0 0 0
0 0 0 0 0 0 0 0 0 0 0
0 0 0 0 0 0 0 0 0 0 0
0 0 0 0 0 0 0 0 0 0 0
0 0 0 0 0 0 0 0 0 0 0
0 0 0 0 0 0 0 0 0 0 0
0 0 0 0 0 0 0 0 0 0 0
0 0 0 0 0 0 0 0 0 0 0
0 0 0 0 0 0 0 0 0 0 0
0 0 0 0 0 0 0 0 0 0 0
0 0 0 0 0 0 0 0 0 0 0
0 0 0 0 0 0 0 0 0 0 0
0 0 0 0 0 0 0 0 0 0 0
0 0 0 0 0 0 0 0 0 0 0
0 0 0 0 0 0 0 0 0 0 0
0 0 0 0 0 0 0 0 0 0 0
0 0 0 0 0 0 0 0 0 0 0
0 0 0 0 0 0 0 0 0 0 0
0 0 0 0 0 0 0 0 0 0 0
0 0 0 0 0 0 0 0 0 0 0
0 0 0 0 0 0 0 0 0 0 0
0 0 0 0 0 0 0 0 0 0 0
0 0 0 0 0 0 0 0 0 0 0
0 0 0 0 0 0 0 0 0 0 0
0 0 0 0 0 0 0 0 0 0 0
0 0 0 0 0 0 0 0 0 0 0
0 0 0 0 0 0 0 0 0 0 0
0 0 0 0 0 0 0 0 0 0 0
0 0 0 0 0 0 0 0 0 0 0
0 0 0 0 0 0 0 0 0 0 0
0 0 0 0 0 0 0 0 0 0 0
0 0 0 0 0 0 0 0 0 0 0
0 0 0 0 0 0 0 0 0 0 0
0 0 0 0 0 0 0 0 0 0 0
0 0 0 0 0 0 0 0 0 0 0
0 0 0 0 0 0 0 0 0 0 0