MODE 2
SIZE 11/70
LIMIT 0/40
COLOR LIMIT 4
STARS 4000/8000/12000
POWERUPS 0/1/0/0
17 17 17 17 14 17 17 17 10 17 17
1 1 0 3 0 4 4 0 20 7 0
7 1 7 3 3 7 18 7 5 5 7
1 1 0 18 0 4 4 0 18 7 0
7 20 7 3 3 7 18 7 5 5 7
1 1 0 9 10 4 4 0 20 7 0
7 18 7 3 3 7 4 7 5 5 7
1 1 14 18 0 4 4 0 5 7 0
7 20 7 3 3 7 18 7 5 5 7
1 1 0 3 0 4 4 0 20 7 0
0 1 7 3 9 7 18 7 5 5 7
1 1 0 18 0 4 4 0 18 7 0
0 20 7 3 3 7 18 7 5 5 7
1 1 8 3 15 4 4 10 20 7 0
0 1 7 3 3 7 18 7 5 5 7
1 1 0 18 0 4 4 0 5 7 0
0 20 7 3 18 7 18 7 5 5 7
1 1 0 9 0 4 4 0 20 7 0
0 18 7 3 3 7 18 7 5 5 7
1 1 0 18 0 4 4 13 18 7 0
0 20 7 3 3 7 4 7 5 5 7
1 1 0 3 0 4 4 0 20 7 0
0 1 7 3 3 7 18 7 5 5 7
1 1 8 18 10 4 4 0 5 7 0
0 20 7 3 3 7 20 7 5 5 7
1 1 0 3 13 4 4 0 18 7 0
0 18 7 3 3 7 18 7 5 5 7
1 1 0 18 0 4 4 8 5 7 0
0 18 7 3 3 7 20 7 5 5 7
1 1 0 9 0 4 4 0 18 7 0
0 18 7 3 3 7 4 7 5 5 7
1 1 8 18 0 4 4 0 5 7 0
0 18 7 3 3 7 20 7 5 5 7
1 1 0 3 0 4 4 0 18 7 0
0 18 7 3 3 7 18 7 5 5 7
1 1 0 18 0 4 4 0 5 7 0
0 18 7 3 3 7 20 7 5 5 7
1 1 0 9 0 4 4 10 18 7 0
0 18 7 3 3 7 18 7 5 5 7
1 1 8 18 0 4 4 0 5 7 9
0 7 0 3 3 0 7 0 5 5 7
0 0 0 0 0 0 0 0 0 0 0
0 0 0 0 0 0 0 0 0 0 0
0 0 0 0 0 0 0 0 0 0 0
0 0 0 0 0 0 0 0 0 0 0
0 0 0 0 0 0 0 0 0 0 0
0 0 0 0 0 0 0 0 0 0 0
0 0 0 0 0 0 0 0 0 0 0
0 0 0 0 0 0 0 0 0 0 0
0 0 0 0 0 0 0 0 0 0 0
0 0 0 0 0 0 0 0 0 0 0
0 0 0 0 0 0 0 0 0 0 0
0 0 0 0 0 0 0 0 0 0 0
0 0 0 0 0 0 0 0 0 0 0
0 0 0 0 0 0 0 0 0 0 0
0 0 0 0 0 0 0 0 0 0 0
0 0 0 0 0 0 0 0 0 0 0
0 0 0 0 0 0 0 0 0 0 0
0 0 0 0 0 0 0 0 0 0 0
0 0 0 0 0 0 0 0 0 0 0
0 0 0 0 0 0 0 0 0 0 0
0 0 0 0 0 0 0 0 0 0 0
0 0 0 0 0 0 0 0 0 0 0
0 0 0 0 0 0 0 0 0 0 0
0 0 0 0 0 0 0 0 0 0 0
0 0 0 0 0 0 0 0 0 0 0
0 0 0 0 0 0 0 0 0 0 0
0 0 0 0 0 0 0 0 0 0 0
0 0 0 0 0 0 0 0 0 0 0
0 0 0 0 0 0 0 0 0 0 0