MODE 2
SIZE 11/70
LIMIT 0/45
COLOR LIMIT 4
STARS 1000/2300/4300
POWERUPS 1/1/1/1
5 3 2 1 4 14 4 1 2 3 5
5 3 2 1 4 4 1 2 3 5 0
0 7 7 7 7 17 7 7 7 7 0
20 5 3 2 1 1 2 3 5 20 0
0 20 5 3 2 17 2 3 5 20 0
20 20 7 7 7 7 7 7 20 20 0
0 20 20 5 3 8 3 5 20 20 0
20 20 20 5 3 3 5 20 20 20 0
0 20 20 0 7 17 7 0 20 20 0
20 20 20 0 5 5 0 20 20 20 0
20 4 20 4 20 14 20 4 20 4 20
20 20 20 0 5 5 0 20 20 20 0
0 20 20 0 7 4 7 0 20 20 0
20 20 20 5 3 3 5 20 20 20 0
0 20 20 7 3 4 3 5 20 20 0
20 20 7 7 7 7 7 7 20 20 0
0 20 5 3 2 4 2 3 5 20 0
20 5 3 2 1 1 2 3 5 20 0
0 7 7 7 7 8 7 7 7 7 0
5 3 2 1 6 6 1 2 3 5 0
5 3 2 1 6 20 6 1 2 3 5
0 0 0 0 0 0 0 0 0 0 0
0 0 0 0 0 0 0 0 0 0 0
0 0 0 0 0 0 0 0 0 0 0
0 0 0 0 0 0 0 0 0 0 0
0 0 0 0 0 0 0 0 0 0 0
0 0 0 0 0 0 0 0 0 0 0
0 0 0 0 0 0 0 0 0 0 0
0 0 0 0 0 0 0 0 0 0 0
0 0 0 0 0 0 0 0 0 0 0
0 0 0 0 0 0 0 0 0 0 0
0 0 0 0 0 0 0 0 0 0 0
0 0 0 0 0 0 0 0 0 0 0
0 0 0 0 0 0 0 0 0 0 0
0 0 0 0 0 0 0 0 0 0 0
0 0 0 0 0 0 0 0 0 0 0
0 0 0 0 0 0 0 0 0 0 0
0 0 0 0 0 0 0 0 0 0 0
0 0 0 0 0 0 0 0 0 0 0
0 0 0 0 0 0 0 0 0 0 0
0 0 0 0 0 0 0 0 0 0 0
0 0 0 0 0 0 0 0 0 0 0
0 0 0 0 0 0 0 0 0 0 0
0 0 0 0 0 0 0 0 0 0 0
0 0 0 0 0 0 0 0 0 0 0
0 0 0 0 0 0 0 0 0 0 0
0 0 0 0 0 0 0 0 0 0 0
0 0 0 0 0 0 0 0 0 0 0
0 0 0 0 0 0 0 0 0 0 0
0 0 0 0 0 0 0 0 0 0 0
0 0 0 0 0 0 0 0 0 0 0
0 0 0 0 0 0 0 0 0 0 0
0 0 0 0 0 0 0 0 0 0 0
0 0 0 0 0 0 0 0 0 0 0
0 0 0 0 0 0 0 0 0 0 0
0 0 0 0 0 0 0 0 0 0 0
0 0 0 0 0 0 0 0 0 0 0
0 0 0 0 0 0 0 0 0 0 0
0 0 0 0 0 0 0 0 0 0 0
0 0 0 0 0 0 0 0 0 0 0
0 0 0 0 0 0 0 0 0 0 0
0 0 0 0 0 0 0 0 0 0 0
0 0 0 0 0 0 0 0 0 0 0
0 0 0 0 0 0 0 0 0 0 0
0 0 0 0 0 0 0 0 0 0 0
0 0 0 0 0 0 0 0 0 0 0
0 0 0 0 0 0 0 0 0 0 0
0 0 0 0 0 0 0 0 0 0 0
0 0 0 0 0 0 0 0 0 0 0
0 0 0 0 0 0 0 0 0 0 0