MODE 2
SIZE 11/70
LIMIT 0/30
COLOR LIMIT 4
STARS 1500/3500/5000
POWERUPS 1/1/0/0
0 0 7 7 7 15 7 7 7 0 0
0 7 7 7 7 7 7 7 7 0 0
0 7 7 7 7 10 7 7 7 7 0
7 7 7 7 7 7 7 7 7 7 0
7 7 7 7 20 14 20 7 7 7 7
7 7 7 7 7 7 7 7 7 7 0
0 7 7 7 7 10 7 7 7 7 0
0 7 7 7 7 7 7 7 7 0 0
0 0 20 7 7 15 7 7 20 0 0
0 7 20 3 3 3 3 20 7 0 0
0 7 3 1 1 8 1 1 3 7 0
7 3 20 3 3 20 3 3 20 7 0
7 7 20 7 7 10 7 7 7 20 7
7 7 7 7 7 7 7 7 7 7 0
0 7 7 1 1 8 1 1 7 7 0
0 7 1 3 3 3 3 1 7 0 0
0 0 7 7 1 1 1 7 7 0 0
0 0 7 7 7 7 7 7 0 0 0
0 0 7 7 7 7 7 7 7 0 0
0 7 7 7 7 7 7 7 7 0 0
0 0 0 0 0 0 0 0 0 0 0
0 0 0 0 0 0 0 0 0 0 0
0 0 0 0 0 0 0 0 0 0 0
0 0 0 0 0 0 0 0 0 0 0
0 0 0 0 0 0 0 0 0 0 0
0 0 0 0 0 0 0 0 0 0 0
0 0 0 0 0 0 0 0 0 0 0
0 0 0 0 0 0 0 0 0 0 0
0 0 0 0 0 0 0 0 0 0 0
0 0 0 0 0 0 0 0 0 0 0
0 0 0 0 0 0 0 0 0 0 0
0 0 0 0 0 0 0 0 0 0 0
0 0 0 0 0 0 0 0 0 0 0
0 0 0 0 0 0 0 0 0 0 0
0 0 0 0 0 0 0 0 0 0 0
0 0 0 0 0 0 0 0 0 0 0
0 0 0 0 0 0 0 0 0 0 0
0 0 0 0 0 0 0 0 0 0 0
0 0 0 0 0 0 0 0 0 0 0
0 0 0 0 0 0 0 0 0 0 0
0 0 0 0 0 0 0 0 0 0 0
0 0 0 0 0 0 0 0 0 0 0
0 0 0 0 0 0 0 0 0 0 0
0 0 0 0 0 0 0 0 0 0 0
0 0 0 0 0 0 0 0 0 0 0
0 0 0 0 0 0 0 0 0 0 0
0 0 0 0 0 0 0 0 0 0 0
0 0 0 0 0 0 0 0 0 0 0
0 0 0 0 0 0 0 0 0 0 0
0 0 0 0 0 0 0 0 0 0 0
0 0 0 0 0 0 0 0 0 0 0
0 0 0 0 0 0 0 0 0 0 0
0 0 0 0 0 0 0 0 0 0 0
0 0 0 0 0 0 0 0 0 0 0
0 0 0 0 0 0 0 0 0 0 0
0 0 0 0 0 0 0 0 0 0 0
0 0 0 0 0 0 0 0 0 0 0
0 0 0 0 0 0 0 0 0 0 0
0 0 0 0 0 0 0 0 0 0 0
0 0 0 0 0 0 0 0 0 0 0
0 0 0 0 0 0 0 0 0 0 0
0 0 0 0 0 0 0 0 0 0 0
0 0 0 0 0 0 0 0 0 0 0
0 0 0 0 0 0 0 0 0 0 0
0 0 0 0 0 0 0 0 0 0 0
0 0 0 0 0 0 0 0 0 0 0
0 0 0 0 0 0 0 0 0 0 0
0 0 0 0 0 0 0 0 0 0 0
0 0 0 0 0 0 0 0 0 0 0
0 0 0 0 0 0 0 0 0 0 0