MODE 2
SIZE 11/70
LIMIT 0/40
COLOR LIMIT 4
STARS 2000/4000/6000
POWERUPS 1/0/0/0
7 0 0 1 0 17 0 1 0 0 7
7 0 1 20 20 20 20 1 0 7 0
0 7 1 3 1 14 1 3 1 7 0
0 7 3 3 1 1 3 3 7 0 0
0 18 7 10 20 18 20 10 7 18 0
0 1 7 3 1 1 3 7 1 0 0
0 0 1 7 1 4 1 7 1 0 0
0 0 1 7 4 4 7 1 0 0 0
0 0 0 1 7 13 7 1 0 0 0
5 0 0 4 7 7 4 0 0 5 0
4 5 0 4 2 8 2 4 0 5 4
4 7 3 4 7 7 4 3 7 4 0
3 7 5 3 7 2 7 3 5 7 3
7 4 5 7 4 4 7 5 4 7 0
0 3 4 7 3 4 3 7 4 3 0
0 3 7 5 3 3 5 7 3 0 0
0 0 7 4 5 11 5 4 7 0 0
0 0 3 4 20 20 4 3 0 0 0
1 20 1 20 1 5 1 1 20 1 1
7 20 20 1 7 7 1 20 20 7 0
1 1 20 1 7 15 7 20 1 20 1
0 0 7 7 7 7 7 7 0 0 0
0 0 7 7 7 7 7 7 7 0 0
0 0 0 0 0 0 0 0 0 0 0
0 0 0 0 0 0 0 0 0 0 0
0 0 0 0 0 0 0 0 0 0 0
0 0 0 0 0 0 0 0 0 0 0
0 0 0 0 0 0 0 0 0 0 0
0 0 0 0 0 0 0 0 0 0 0
0 0 0 0 0 0 0 0 0 0 0
0 0 0 0 0 0 0 0 0 0 0
0 0 0 0 0 0 0 0 0 0 0
0 0 0 0 0 0 0 0 0 0 0
0 0 0 0 0 0 0 0 0 0 0
0 0 0 0 0 0 0 0 0 0 0
0 0 0 0 0 0 0 0 0 0 0
0 0 0 0 0 0 0 0 0 0 0
0 0 0 0 0 0 0 0 0 0 0
0 0 0 0 0 0 0 0 0 0 0
0 0 0 0 0 0 0 0 0 0 0
0 0 0 0 0 0 0 0 0 0 0
0 0 0 0 0 0 0 0 0 0 0
0 0 0 0 0 0 0 0 0 0 0
0 0 0 0 0 0 0 0 0 0 0
0 0 0 0 0 0 0 0 0 0 0
0 0 0 0 0 0 0 0 0 0 0
0 0 0 0 0 0 0 0 0 0 0
0 0 0 0 0 0 0 0 0 0 0
0 0 0 0 0 0 0 0 0 0 0
0 0 0 0 0 0 0 0 0 0 0
0 0 0 0 0 0 0 0 0 0 0
0 0 0 0 0 0 0 0 0 0 0
0 0 0 0 0 0 0 0 0 0 0
0 0 0 0 0 0 0 0 0 0 0
0 0 0 0 0 0 0 0 0 0 0
0 0 0 0 0 0 0 0 0 0 0
0 0 0 0 0 0 0 0 0 0 0
0 0 0 0 0 0 0 0 0 0 0
0 0 0 0 0 0 0 0 0 0 0
0 0 0 0 0 0 0 0 0 0 0
0 0 0 0 0 0 0 0 0 0 0
0 0 0 0 0 0 0 0 0 0 0
0 0 0 0 0 0 0 0 0 0 0
0 0 0 0 0 0 0 0 0 0 0
0 0 0 0 0 0 0 0 0 0 0
0 0 0 0 0 0 0 0 0 0 0
0 0 0 0 0 0 0 0 0 0 0
0 0 0 0 0 0 0 0 0 0 0
0 0 0 0 0 0 0 0 0 0 0
0 0 0 0 0 0 0 0 0 0 0