MODE 2
SIZE 11/70
LIMIT 0/37
COLOR LIMIT 4
STARS 1500/3500/5000
POWERUPS 1/0/1/0
0 1 1 1 7 1 1 18 1 1 0
0 1 1 7 7 1 18 18 1 0 0
0 1 1 7 7 7 13 18 1 1 0
0 20 7 7 7 7 20 20 20 0 0
0 1 1 7 7 7 1 18 1 1 0
0 1 1 7 7 1 18 18 1 0 0
0 1 1 1 7 10 18 14 18 1 0
0 0 3 3 3 7 18 18 0 0 0
0 0 0 3 3 7 7 18 0 0 0
0 0 20 20 7 8 7 20 0 0 0
0 0 0 3 3 7 7 3 0 0 0
0 0 3 3 3 7 3 3 0 0 0
0 2 2 2 7 2 2 11 2 2 0
0 2 2 7 7 2 17 17 2 0 0
0 20 20 7 7 7 20 20 20 20 0
0 2 2 7 7 2 2 18 2 0 0
0 2 2 2 7 2 2 18 2 2 0
0 0 4 4 20 20 4 4 0 0 0
0 0 0 4 20 4 20 4 0 0 0
17 17 17 20 4 4 20 17 17 17 17
0 0 0 4 20 4 20 4 0 0 0
0 0 4 4 20 20 4 4 0 0 0
7 7 7 7 7 7 7 7 7 7 7
7 7 7 7 7 7 7 7 7 7 0
0 0 0 0 0 0 0 0 0 0 0
0 0 0 0 0 0 0 0 0 0 0
0 0 0 0 0 0 0 0 0 0 0
0 0 0 0 0 0 0 0 0 0 0
0 0 0 0 0 0 0 0 0 0 0
0 0 0 0 0 0 0 0 0 0 0
0 0 0 0 0 0 0 0 0 0 0
0 0 0 0 0 0 0 0 0 0 0
0 0 0 0 0 0 0 0 0 0 0
0 0 0 0 0 0 0 0 0 0 0
0 0 0 0 0 0 0 0 0 0 0
0 0 0 0 0 0 0 0 0 0 0
0 0 0 0 0 0 0 0 0 0 0
0 0 0 0 0 0 0 0 0 0 0
0 0 0 0 0 0 0 0 0 0 0
0 0 0 0 0 0 0 0 0 0 0
0 0 0 0 0 0 0 0 0 0 0
0 0 0 0 0 0 0 0 0 0 0
0 0 0 0 0 0 0 0 0 0 0
0 0 0 0 0 0 0 0 0 0 0
0 0 0 0 0 0 0 0 0 0 0
0 0 0 0 0 0 0 0 0 0 0
0 0 0 0 0 0 0 0 0 0 0
0 0 0 0 0 0 0 0 0 0 0
0 0 0 0 0 0 0 0 0 0 0
0 0 0 0 0 0 0 0 0 0 0
0 0 0 0 0 0 0 0 0 0 0
0 0 0 0 0 0 0 0 0 0 0
0 0 0 0 0 0 0 0 0 0 0
0 0 0 0 0 0 0 0 0 0 0
0 0 0 0 0 0 0 0 0 0 0
0 0 0 0 0 0 0 0 0 0 0
0 0 0 0 0 0 0 0 0 0 0
0 0 0 0 0 0 0 0 0 0 0
0 0 0 0 0 0 0 0 0 0 0
0 0 0 0 0 0 0 0 0 0 0
0 0 0 0 0 0 0 0 0 0 0
0 0 0 0 0 0 0 0 0 0 0
0 0 0 0 0 0 0 0 0 0 0
0 0 0 0 0 0 0 0 0 0 0
0 0 0 0 0 0 0 0 0 0 0
0 0 0 0 0 0 0 0 0 0 0
0 0 0 0 0 0 0 0 0 0 0
0 0 0 0 0 0 0 0 0 0 0
0 0 0 0 0 0 0 0 0 0 0
0 0 0 0 0 0 0 0 0 0 0