MODE 2
SIZE 11/70
LIMIT 0/28
COLOR LIMIT 4
STARS 1000/2500/4000
POWERUPS 1/0/0/0
3 3 3 3 3 3 3 3 3 3 3
3 1 1 1 1 1 1 1 1 3 2
20 20 20 17 4 4 4 17 20 20 20
2 3 1 4 5 5 4 1 3 2 0
0 2 3 1 4 15 4 1 3 2 0
0 2 3 1 4 4 1 3 2 0 0
0 0 20 20 20 17 20 20 20 0 0
0 0 2 3 1 1 3 2 0 0 0
0 0 0 2 3 1 3 2 0 0 0
0 0 0 2 3 3 2 0 0 0 0
18 18 18 18 6 6 6 18 18 18 18
0 0 0 1 3 3 1 0 0 0 0
0 0 0 1 3 18 3 1 0 0 0
0 0 20 20 2 2 20 20 0 0 0
0 0 1 3 2 13 2 3 1 0 0
0 1 3 18 4 4 18 3 1 0 0
0 20 20 18 4 5 4 18 20 20 0
1 3 2 4 5 5 4 2 3 1 0
1 3 2 17 4 4 4 17 2 3 1
3 18 2 2 18 18 2 2 18 3 0
3 3 3 3 3 11 3 3 3 3 3
0 20 20 0 20 20 0 20 20 0 0
0 0 0 20 20 0 20 20 0 0 0
0 0 0 0 0 0 0 0 0 0 0
0 0 0 0 0 0 0 0 0 0 0
0 0 0 0 0 0 0 0 0 0 0
0 0 0 0 0 0 0 0 0 0 0
0 0 0 0 0 0 0 0 0 0 0
0 0 0 0 0 0 0 0 0 0 0
0 0 0 0 0 0 0 0 0 0 0
0 0 0 0 0 0 0 0 0 0 0
0 0 0 0 0 0 0 0 0 0 0
0 0 0 0 0 0 0 0 0 0 0
0 0 0 0 0 0 0 0 0 0 0
0 0 0 0 0 0 0 0 0 0 0
0 0 0 0 0 0 0 0 0 0 0
0 0 0 0 0 0 0 0 0 0 0
0 0 0 0 0 0 0 0 0 0 0
0 0 0 0 0 0 0 0 0 0 0
0 0 0 0 0 0 0 0 0 0 0
0 0 0 0 0 0 0 0 0 0 0
0 0 0 0 0 0 0 0 0 0 0
0 0 0 0 0 0 0 0 0 0 0
0 0 0 0 0 0 0 0 0 0 0
0 0 0 0 0 0 0 0 0 0 0
0 0 0 0 0 0 0 0 0 0 0
0 0 0 0 0 0 0 0 0 0 0
0 0 0 0 0 0 0 0 0 0 0
0 0 0 0 0 0 0 0 0 0 0
0 0 0 0 0 0 0 0 0 0 0
0 0 0 0 0 0 0 0 0 0 0
0 0 0 0 0 0 0 0 0 0 0
0 0 0 0 0 0 0 0 0 0 0
0 0 0 0 0 0 0 0 0 0 0
0 0 0 0 0 0 0 0 0 0 0
0 0 0 0 0 0 0 0 0 0 0
0 0 0 0 0 0 0 0 0 0 0
0 0 0 0 0 0 0 0 0 0 0
0 0 0 0 0 0 0 0 0 0 0
0 0 0 0 0 0 0 0 0 0 0
0 0 0 0 0 0 0 0 0 0 0
0 0 0 0 0 0 0 0 0 0 0
0 0 0 0 0 0 0 0 0 0 0
0 0 0 0 0 0 0 0 0 0 0
0 0 0 0 0 0 0 0 0 0 0
0 0 0 0 0 0 0 0 0 0 0
0 0 0 0 0 0 0 0 0 0 0
0 0 0 0 0 0 0 0 0 0 0
0 0 0 0 0 0 0 0 0 0 0
0 0 0 0 0 0 0 0 0 0 0