MODE 2
SIZE 11/70
LIMIT 0/40
COLOR LIMIT 4
STARS 2000/4000/5500
POWERUPS 1/1/1/1
17 20 17 15 17 20 17 15 17 20 17
20 4 4 2 20 20 2 4 4 20 0
20 1 1 2 20 10 20 2 1 1 20
20 1 2 1 20 20 1 2 1 20 0
18 20 2 4 4 20 4 4 2 20 18
18 20 3 4 4 4 4 3 20 18 0
18 18 20 3 1 1 1 3 20 18 18
18 20 1 3 1 1 3 1 20 18 0
18 20 4 4 3 20 3 4 4 20 18
20 4 4 4 20 20 4 4 4 20 0
20 1 3 1 20 11 20 1 3 1 20
20 1 3 1 20 20 1 3 1 20 0
18 20 4 2 4 20 4 2 4 20 18
18 20 4 2 4 4 2 4 20 18 0
18 18 20 3 1 1 1 3 20 18 18
18 20 1 3 1 1 3 1 20 18 0
18 20 4 2 4 20 4 2 4 20 18
20 4 2 4 20 20 4 2 4 20 0
20 1 3 1 20 12 20 1 3 1 20
20 1 3 1 20 20 1 3 1 20 0
18 20 4 2 4 20 4 2 4 20 18
18 20 4 2 4 4 2 4 20 18 0
20 20 3 20 3 20 3 20 3 20 3
7 3 7 3 7 3 7 3 7 3 0
0 3 7 3 7 3 7 3 7 3 0
0 0 0 0 0 0 0 0 0 0 0
0 0 0 0 0 0 0 0 0 0 0
0 0 0 0 0 0 0 0 0 0 0
0 0 0 0 0 0 0 0 0 0 0
0 0 0 0 0 0 0 0 0 0 0
0 0 0 0 0 0 0 0 0 0 0
0 0 0 0 0 0 0 0 0 0 0
0 0 0 0 0 0 0 0 0 0 0
0 0 0 0 0 0 0 0 0 0 0
0 0 0 0 0 0 0 0 0 0 0
0 0 0 0 0 0 0 0 0 0 0
0 0 0 0 0 0 0 0 0 0 0
0 0 0 0 0 0 0 0 0 0 0
0 0 0 0 0 0 0 0 0 0 0
0 0 0 0 0 0 0 0 0 0 0
0 0 0 0 0 0 0 0 0 0 0
0 0 0 0 0 0 0 0 0 0 0
0 0 0 0 0 0 0 0 0 0 0
0 0 0 0 0 0 0 0 0 0 0
0 0 0 0 0 0 0 0 0 0 0
0 0 0 0 0 0 0 0 0 0 0
0 0 0 0 0 0 0 0 0 0 0
0 0 0 0 0 0 0 0 0 0 0
0 0 0 0 0 0 0 0 0 0 0
0 0 0 0 0 0 0 0 0 0 0
0 0 0 0 0 0 0 0 0 0 0
0 0 0 0 0 0 0 0 0 0 0
0 0 0 0 0 0 0 0 0 0 0
0 0 0 0 0 0 0 0 0 0 0
0 0 0 0 0 0 0 0 0 0 0
0 0 0 0 0 0 0 0 0 0 0
0 0 0 0 0 0 0 0 0 0 0
0 0 0 0 0 0 0 0 0 0 0
0 0 0 0 0 0 0 0 0 0 0
0 0 0 0 0 0 0 0 0 0 0
0 0 0 0 0 0 0 0 0 0 0
0 0 0 0 0 0 0 0 0 0 0
0 0 0 0 0 0 0 0 0 0 0
0 0 0 0 0 0 0 0 0 0 0
0 0 0 0 0 0 0 0 0 0 0
0 0 0 0 0 0 0 0 0 0 0
0 0 0 0 0 0 0 0 0 0 0
0 0 0 0 0 0 0 0 0 0 0
0 0 0 0 0 0 0 0 0 0 0
0 0 0 0 0 0 0 0 0 0 0