MODE 2
SIZE 11/70
LIMIT 0/40
COLOR LIMIT 4
STARS 2000/3500/6000
POWERUPS 1/0/1/0
7 7 7 1 1 14 1 1 7 7 7
7 7 7 1 20 20 1 7 7 7 0
4 20 4 4 4 20 4 4 4 20 4
7 7 7 7 1 1 7 7 7 7 0
7 7 7 7 1 1 1 7 7 7 7
4 4 20 4 4 4 4 20 4 4 0
7 7 7 1 1 20 1 1 7 7 7
7 7 18 1 20 20 1 18 7 7 0
18 18 18 1 20 7 20 1 18 18 18
18 20 20 20 7 7 20 20 20 18 0
7 18 20 7 7 13 7 7 20 18 7
7 18 20 7 14 11 7 20 18 7 0
7 18 20 7 7 12 7 7 20 18 7
18 20 20 20 7 7 20 20 20 18 0
18 18 18 1 20 7 20 1 18 18 18
7 7 18 1 20 20 1 18 7 7 0
7 7 7 1 1 20 1 1 7 7 7
3 3 20 3 3 20 3 3 20 3 0
7 7 7 7 1 1 1 7 7 7 7
7 7 7 7 1 1 7 7 7 7 0
3 3 3 3 20 3 3 20 3 3 3
7 7 7 1 2 2 1 7 7 7 0
7 7 7 1 2 8 2 1 7 7 7
18 18 18 18 18 18 18 18 18 18 0
0 0 0 0 0 0 0 0 0 0 0
0 0 0 0 0 0 0 0 0 0 0
0 0 0 0 0 0 0 0 0 0 0
0 0 0 0 0 0 0 0 0 0 0
0 0 0 0 0 0 0 0 0 0 0
0 0 0 0 0 0 0 0 0 0 0
0 0 0 0 0 0 0 0 0 0 0
0 0 0 0 0 0 0 0 0 0 0
0 0 0 0 0 0 0 0 0 0 0
0 0 0 0 0 0 0 0 0 0 0
0 0 0 0 0 0 0 0 0 0 0
0 0 0 0 0 0 0 0 0 0 0
0 0 0 0 0 0 0 0 0 0 0
0 0 0 0 0 0 0 0 0 0 0
0 0 0 0 0 0 0 0 0 0 0
0 0 0 0 0 0 0 0 0 0 0
0 0 0 0 0 0 0 0 0 0 0
0 0 0 0 0 0 0 0 0 0 0
0 0 0 0 0 0 0 0 0 0 0
0 0 0 0 0 0 0 0 0 0 0
0 0 0 0 0 0 0 0 0 0 0
0 0 0 0 0 0 0 0 0 0 0
0 0 0 0 0 0 0 0 0 0 0
0 0 0 0 0 0 0 0 0 0 0
0 0 0 0 0 0 0 0 0 0 0
0 0 0 0 0 0 0 0 0 0 0
0 0 0 0 0 0 0 0 0 0 0
0 0 0 0 0 0 0 0 0 0 0
0 0 0 0 0 0 0 0 0 0 0
0 0 0 0 0 0 0 0 0 0 0
0 0 0 0 0 0 0 0 0 0 0
0 0 0 0 0 0 0 0 0 0 0
0 0 0 0 0 0 0 0 0 0 0
0 0 0 0 0 0 0 0 0 0 0
0 0 0 0 0 0 0 0 0 0 0
0 0 0 0 0 0 0 0 0 0 0
0 0 0 0 0 0 0 0 0 0 0
0 0 0 0 0 0 0 0 0 0 0
0 0 0 0 0 0 0 0 0 0 0
0 0 0 0 0 0 0 0 0 0 0
0 0 0 0 0 0 0 0 0 0 0
0 0 0 0 0 0 0 0 0 0 0
0 0 0 0 0 0 0 0 0 0 0
0 0 0 0 0 0 0 0 0 0 0
0 0 0 0 0 0 0 0 0 0 0
0 0 0 0 0 0 0 0 0 0 0