MODE 2
SIZE 11/70
LIMIT 0/45
COLOR LIMIT 4
STARS 2000/3500/6000
POWERUPS 1/0/1/0
1 1 3 3 4 14 4 3 3 1 1
17 17 20 20 18 18 20 20 17 17 0
7 7 20 20 18 8 18 20 20 7 7
20 20 20 18 20 20 18 20 20 20 20
2 2 2 20 2 13 2 20 2 2 2
7 17 7 20 2 2 20 7 17 7 0
7 17 7 7 20 8 20 7 7 17 7
20 20 20 20 20 20 20 20 20 20 20
3 3 20 3 3 15 3 3 20 3 3
7 17 7 7 3 3 7 7 17 7 0
7 7 17 7 7 10 7 7 17 7 7
20 20 20 20 20 20 20 20 20 20 20
4 4 20 4 4 11 4 4 20 4 4
7 17 7 7 4 4 7 7 17 7 0
7 7 17 7 7 18 7 7 17 7 7
1 1 20 1 18 18 1 20 1 1 0
1 1 20 1 18 1 18 1 20 1 1
2 20 2 2 18 18 2 2 20 2 0
0 0 0 0 2 18 2 0 0 0 0
0 0 0 0 20 20 0 0 0 0 0
0 0 0 0 0 20 0 0 0 0 0
0 0 0 0 0 0 0 0 0 0 0
0 0 0 0 0 0 0 0 0 0 0
0 0 0 0 0 0 0 0 0 0 0
0 0 0 0 0 0 0 0 0 0 0
0 0 0 0 0 0 0 0 0 0 0
0 0 0 0 0 0 0 0 0 0 0
0 0 0 0 0 0 0 0 0 0 0
0 0 0 0 0 0 0 0 0 0 0
0 0 0 0 0 0 0 0 0 0 0
0 0 0 0 0 0 0 0 0 0 0
0 0 0 0 0 0 0 0 0 0 0
0 0 0 0 0 0 0 0 0 0 0
0 0 0 0 0 0 0 0 0 0 0
0 0 0 0 0 0 0 0 0 0 0
0 0 0 0 0 0 0 0 0 0 0
0 0 0 0 0 0 0 0 0 0 0
0 0 0 0 0 0 0 0 0 0 0
0 0 0 0 0 0 0 0 0 0 0
0 0 0 0 0 0 0 0 0 0 0
0 0 0 0 0 0 0 0 0 0 0
0 0 0 0 0 0 0 0 0 0 0
0 0 0 0 0 0 0 0 0 0 0
0 0 0 0 0 0 0 0 0 0 0
0 0 0 0 0 0 0 0 0 0 0
0 0 0 0 0 0 0 0 0 0 0
0 0 0 0 0 0 0 0 0 0 0
0 0 0 0 0 0 0 0 0 0 0
0 0 0 0 0 0 0 0 0 0 0
0 0 0 0 0 0 0 0 0 0 0
0 0 0 0 0 0 0 0 0 0 0
0 0 0 0 0 0 0 0 0 0 0
0 0 0 0 0 0 0 0 0 0 0
0 0 0 0 0 0 0 0 0 0 0
0 0 0 0 0 0 0 0 0 0 0
0 0 0 0 0 0 0 0 0 0 0
0 0 0 0 0 0 0 0 0 0 0
0 0 0 0 0 0 0 0 0 0 0
0 0 0 0 0 0 0 0 0 0 0
0 0 0 0 0 0 0 0 0 0 0
0 0 0 0 0 0 0 0 0 0 0
0 0 0 0 0 0 0 0 0 0 0
0 0 0 0 0 0 0 0 0 0 0
0 0 0 0 0 0 0 0 0 0 0
0 0 0 0 0 0 0 0 0 0 0
0 0 0 0 0 0 0 0 0 0 0
0 0 0 0 0 0 0 0 0 0 0
0 0 0 0 0 0 0 0 0 0 0
0 0 0 0 0 0 0 0 0 0 0
0 0 0 0 0 0 0 0 0 0 0