MODE 2
SIZE 11/70
LIMIT 0/35
COLOR LIMIT 4
STARS 5000/8000/14000
POWERUPS 1/1/1/1
17 2 2 17 3 3 3 17 5 5 17
7 2 7 7 3 3 7 7 5 7 0
7 2 2 7 3 19 3 7 5 5 7
18 15 18 18 18 18 18 18 13 18 0
7 2 2 7 3 19 3 7 5 5 7
7 2 7 7 3 3 7 7 5 7 0
7 2 2 7 3 19 3 7 5 5 7
7 2 7 7 3 3 7 7 5 7 0
7 2 2 7 3 8 3 7 5 5 7
7 2 7 7 3 3 7 7 5 7 0
7 2 2 7 3 19 3 7 5 5 7
18 15 18 18 18 18 18 18 13 18 0
7 2 2 7 3 19 3 7 5 5 7
7 2 7 7 3 3 7 7 5 7 0
7 2 2 7 3 19 3 7 5 5 7
7 2 7 7 3 3 7 7 5 7 0
7 2 2 7 3 19 3 7 5 5 7
7 2 7 7 3 3 7 7 5 7 0
7 2 2 7 3 19 3 7 5 5 7
7 2 7 7 3 3 7 7 5 7 0
7 2 2 7 3 19 3 7 5 5 7
7 2 7 7 3 3 7 7 5 7 0
7 2 2 7 3 19 3 7 5 5 7
7 2 7 7 3 3 7 7 5 7 0
7 2 2 7 3 14 3 7 5 5 7
18 15 18 18 18 18 18 18 13 18 0
7 2 2 7 3 19 3 7 5 5 7
7 2 7 7 3 3 7 7 5 7 0
7 2 2 7 3 19 3 7 5 5 7
7 2 7 7 3 3 7 7 5 7 0
7 7 7 7 7 7 7 7 7 7 7
7 2 7 7 3 3 7 7 5 7 0
7 2 2 7 3 3 3 7 5 5 7
0 0 0 0 0 0 0 0 0 0 0
0 0 0 0 0 0 0 0 0 0 0
0 0 0 0 0 0 0 0 0 0 0
0 0 0 0 0 0 0 0 0 0 0
0 0 0 0 0 0 0 0 0 0 0
0 0 0 0 0 0 0 0 0 0 0
0 0 0 0 0 0 0 0 0 0 0
0 0 0 0 0 0 0 0 0 0 0
0 0 0 0 0 0 0 0 0 0 0
0 0 0 0 0 0 0 0 0 0 0
0 0 0 0 0 0 0 0 0 0 0
0 0 0 0 0 0 0 0 0 0 0
0 0 0 0 0 0 0 0 0 0 0
0 0 0 0 0 0 0 0 0 0 0
0 0 0 0 0 0 0 0 0 0 0
0 0 0 0 0 0 0 0 0 0 0
0 0 0 0 0 0 0 0 0 0 0
0 0 0 0 0 0 0 0 0 0 0
0 0 0 0 0 0 0 0 0 0 0
0 0 0 0 0 0 0 0 0 0 0
0 0 0 0 0 0 0 0 0 0 0
0 0 0 0 0 0 0 0 0 0 0
0 0 0 0 0 0 0 0 0 0 0
0 0 0 0 0 0 0 0 0 0 0
0 0 0 0 0 0 0 0 0 0 0
0 0 0 0 0 0 0 0 0 0 0
0 0 0 0 0 0 0 0 0 0 0
0 0 0 0 0 0 0 0 0 0 0
0 0 0 0 0 0 0 0 0 0 0
0 0 0 0 0 0 0 0 0 0 0
0 0 0 0 0 0 0 0 0 0 0
0 0 0 0 0 0 0 0 0 0 0
0 0 0 0 0 0 0 0 0 0 0
0 0 0 0 0 0 0 0 0 0 0
0 0 0 0 0 0 0 0 0 0 0
0 0 0 0 0 0 0 0 0 0 0
0 0 0 0 0 0 0 0 0 0 0