MODE 2
SIZE 11/70
LIMIT 0/20
COLOR LIMIT 4
STARS 1000/2500/5000
POWERUPS 0/0/0/0
2 17 17 17 17 1 17 17 17 17 3
2 2 17 17 1 1 17 17 3 3 0
2 11 2 0 1 13 1 0 3 12 3
2 18 0 0 1 1 0 0 18 3 0
0 0 18 2 0 18 0 3 18 0 0
0 2 2 2 1 1 3 3 3 0 0
0 0 2 18 1 1 1 18 3 0 0
0 0 0 18 2 3 18 0 0 0 0
0 0 0 2 2 18 3 3 0 0 0
0 0 0 2 1 1 3 0 0 0 0
0 0 0 0 1 3 2 0 0 0 0
0 0 0 3 1 3 2 0 0 0 0
0 0 0 0 18 18 18 0 0 0 0
0 0 3 18 1 1 18 2 0 0 0
0 0 3 3 1 13 2 2 2 0 0
0 0 18 3 1 1 2 18 0 0 0
0 3 18 0 0 18 0 0 18 2 0
3 12 3 0 1 1 0 2 11 2 0
0 18 3 0 1 1 1 0 2 18 0
18 0 0 0 1 1 0 0 0 18 0
0 0 0 0 0 0 0 0 0 0 0
0 0 0 0 0 0 0 0 0 0 0
0 0 0 0 0 0 0 0 0 0 0
0 0 0 0 0 0 0 0 0 0 0
0 0 0 0 0 0 0 0 0 0 0
0 0 0 0 0 0 0 0 0 0 0
0 0 0 0 0 0 0 0 0 0 0
0 0 0 0 0 0 0 0 0 0 0
0 0 0 0 0 0 0 0 0 0 0
0 0 0 0 0 0 0 0 0 0 0
0 0 0 0 0 0 0 0 0 0 0
0 0 0 0 0 0 0 0 0 0 0
0 0 0 0 0 0 0 0 0 0 0
0 0 0 0 0 0 0 0 0 0 0
0 0 0 0 0 0 0 0 0 0 0
0 0 0 0 0 0 0 0 0 0 0
0 0 0 0 0 0 0 0 0 0 0
0 0 0 0 0 0 0 0 0 0 0
0 0 0 0 0 0 0 0 0 0 0
0 0 0 0 0 0 0 0 0 0 0
0 0 0 0 0 0 0 0 0 0 0
0 0 0 0 0 0 0 0 0 0 0
0 0 0 0 0 0 0 0 0 0 0
0 0 0 0 0 0 0 0 0 0 0
0 0 0 0 0 0 0 0 0 0 0
0 0 0 0 0 0 0 0 0 0 0
0 0 0 0 0 0 0 0 0 0 0
0 0 0 0 0 0 0 0 0 0 0
0 0 0 0 0 0 0 0 0 0 0
0 0 0 0 0 0 0 0 0 0 0
0 0 0 0 0 0 0 0 0 0 0
0 0 0 0 0 0 0 0 0 0 0
0 0 0 0 0 0 0 0 0 0 0
0 0 0 0 0 0 0 0 0 0 0
0 0 0 0 0 0 0 0 0 0 0
0 0 0 0 0 0 0 0 0 0 0
0 0 0 0 0 0 0 0 0 0 0
0 0 0 0 0 0 0 0 0 0 0
0 0 0 0 0 0 0 0 0 0 0
0 0 0 0 0 0 0 0 0 0 0
0 0 0 0 0 0 0 0 0 0 0
0 0 0 0 0 0 0 0 0 0 0
0 0 0 0 0 0 0 0 0 0 0
0 0 0 0 0 0 0 0 0 0 0
0 0 0 0 0 0 0 0 0 0 0
0 0 0 0 0 0 0 0 0 0 0
0 0 0 0 0 0 0 0 0 0 0
0 0 0 0 0 0 0 0 0 0 0
0 0 0 0 0 0 0 0 0 0 0
0 0 0 0 0 0 0 0 0 0 0