MODE 2
SIZE 11/70
LIMIT 0/40
COLOR LIMIT 4
STARS 1000/3000/6000
POWERUPS 0/0/1/0
4 4 4 20 7 7 7 20 4 4 4
4 4 20 20 7 7 20 20 4 4 4
7 7 20 1 20 7 20 13 20 7 7
7 20 1 1 20 20 1 5 20 7 7
7 20 18 18 2 20 2 1 5 20 7
20 18 10 18 2 2 1 1 5 20 7
7 20 18 18 2 14 2 5 5 20 7
7 20 1 2 2 2 2 5 20 7 7
4 7 20 1 1 1 1 1 20 7 4
4 4 20 3 1 1 1 20 4 4 0
7 7 7 20 3 1 1 20 7 7 7
4 4 4 20 3 3 20 4 4 4 4
7 7 7 7 20 3 20 7 7 7 7
4 4 4 4 20 20 4 4 4 4 4
7 7 7 7 7 20 7 7 7 7 7
7 7 7 7 20 20 7 7 7 7 7
4 4 4 4 20 18 20 4 4 4 4
7 7 7 20 1 1 20 7 7 7 7
7 7 7 20 1 17 1 20 7 7 7
4 4 20 20 20 20 20 20 4 4 4
7 7 20 20 20 20 20 20 20 7 7
7 20 1 1 5 5 1 1 20 7 7
4 20 20 20 20 20 20 20 20 20 4
4 4 7 7 4 4 7 7 4 4 4
0 0 18 4 18 4 18 4 18 4 0
0 0 0 0 0 0 0 0 0 0 0
0 0 0 0 0 0 0 0 0 0 0
0 0 0 0 0 0 0 0 0 0 0
0 0 0 0 0 0 0 0 0 0 0
0 0 0 0 0 0 0 0 0 0 0
0 0 0 0 0 0 0 0 0 0 0
0 0 0 0 0 0 0 0 0 0 0
0 0 0 0 0 0 0 0 0 0 0
0 0 0 0 0 0 0 0 0 0 0
0 0 0 0 0 0 0 0 0 0 0
0 0 0 0 0 0 0 0 0 0 0
0 0 0 0 0 0 0 0 0 0 0
0 0 0 0 0 0 0 0 0 0 0
0 0 0 0 0 0 0 0 0 0 0
0 0 0 0 0 0 0 0 0 0 0
0 0 0 0 0 0 0 0 0 0 0
0 0 0 0 0 0 0 0 0 0 0
0 0 0 0 0 0 0 0 0 0 0
0 0 0 0 0 0 0 0 0 0 0
0 0 0 0 0 0 0 0 0 0 0
0 0 0 0 0 0 0 0 0 0 0
0 0 0 0 0 0 0 0 0 0 0
0 0 0 0 0 0 0 0 0 0 0
0 0 0 0 0 0 0 0 0 0 0
0 0 0 0 0 0 0 0 0 0 0
0 0 0 0 0 0 0 0 0 0 0
0 0 0 0 0 0 0 0 0 0 0
0 0 0 0 0 0 0 0 0 0 0
0 0 0 0 0 0 0 0 0 0 0
0 0 0 0 0 0 0 0 0 0 0
0 0 0 0 0 0 0 0 0 0 0
0 0 0 0 0 0 0 0 0 0 0
0 0 0 0 0 0 0 0 0 0 0
0 0 0 0 0 0 0 0 0 0 0
0 0 0 0 0 0 0 0 0 0 0
0 0 0 0 0 0 0 0 0 0 0
0 0 0 0 0 0 0 0 0 0 0
0 0 0 0 0 0 0 0 0 0 0
0 0 0 0 0 0 0 0 0 0 0
0 0 0 0 0 0 0 0 0 0 0
0 0 0 0 0 0 0 0 0 0 0
0 0 0 0 0 0 0 0 0 0 0
0 0 0 0 0 0 0 0 0 0 0
0 0 0 0 0 0 0 0 0 0 0
0 0 0 0 0 0 0 0 0 0 0