MODE 2
SIZE 11/70
LIMIT 0/45
COLOR LIMIT 4
STARS 2500/4000/7000
POWERUPS 1/1/0/0
18 18 18 18 5 5 5 18 18 18 18
18 20 1 1 20 20 1 1 20 18 7
7 18 1 13 1 2 1 13 1 18 7
7 18 1 1 2 2 1 1 18 7 7
7 7 5 20 2 11 2 20 5 7 7
7 7 5 3 2 2 3 5 7 7 7
7 7 7 5 3 2 3 5 7 7 7
7 7 7 5 3 3 5 7 7 7 7
7 7 7 7 18 3 18 7 7 7 7
7 7 7 7 18 18 7 7 7 7 7
7 7 7 7 7 18 7 7 7 7 7
7 7 7 7 5 5 7 7 7 7 7
7 7 7 7 5 1 5 7 7 7 7
7 7 7 5 1 1 5 7 7 7 7
7 7 7 5 1 4 1 5 7 7 7
7 7 18 1 4 4 1 18 7 7 7
7 7 18 20 4 15 4 20 18 7 7
7 18 3 3 4 4 3 3 18 7 7
7 5 3 16 3 20 3 16 3 5 7
5 20 3 3 20 20 3 3 20 5 7
5 18 18 18 18 6 18 18 18 18 5
0 0 0 0 0 0 0 0 0 0 0
0 0 0 0 0 0 0 0 0 0 0
0 0 0 0 0 0 0 0 0 0 0
0 0 0 0 0 0 0 0 0 0 0
0 0 0 0 0 0 0 0 0 0 0
0 0 0 0 0 0 0 0 0 0 0
0 0 0 0 0 0 0 0 0 0 0
0 0 0 0 0 0 0 0 0 0 0
0 0 0 0 0 0 0 0 0 0 0
0 0 0 0 0 0 0 0 0 0 0
0 0 0 0 0 0 0 0 0 0 0
0 0 0 0 0 0 0 0 0 0 0
0 0 0 0 0 0 0 0 0 0 0
0 0 0 0 0 0 0 0 0 0 0
0 0 0 0 0 0 0 0 0 0 0
0 0 0 0 0 0 0 0 0 0 0
0 0 0 0 0 0 0 0 0 0 0
0 0 0 0 0 0 0 0 0 0 0
0 0 0 0 0 0 0 0 0 0 0
0 0 0 0 0 0 0 0 0 0 0
0 0 0 0 0 0 0 0 0 0 0
0 0 0 0 0 0 0 0 0 0 0
0 0 0 0 0 0 0 0 0 0 0
0 0 0 0 0 0 0 0 0 0 0
0 0 0 0 0 0 0 0 0 0 0
0 0 0 0 0 0 0 0 0 0 0
0 0 0 0 0 0 0 0 0 0 0
0 0 0 0 0 0 0 0 0 0 0
0 0 0 0 0 0 0 0 0 0 0
0 0 0 0 0 0 0 0 0 0 0
0 0 0 0 0 0 0 0 0 0 0
0 0 0 0 0 0 0 0 0 0 0
0 0 0 0 0 0 0 0 0 0 0
0 0 0 0 0 0 0 0 0 0 0
0 0 0 0 0 0 0 0 0 0 0
0 0 0 0 0 0 0 0 0 0 0
0 0 0 0 0 0 0 0 0 0 0
0 0 0 0 0 0 0 0 0 0 0
0 0 0 0 0 0 0 0 0 0 0
0 0 0 0 0 0 0 0 0 0 0
0 0 0 0 0 0 0 0 0 0 0
0 0 0 0 0 0 0 0 0 0 0
0 0 0 0 0 0 0 0 0 0 0
0 0 0 0 0 0 0 0 0 0 0
0 0 0 0 0 0 0 0 0 0 0
0 0 0 0 0 0 0 0 0 0 0
0 0 0 0 0 0 0 0 0 0 0
0 0 0 0 0 0 0 0 0 0 0
0 0 0 0 0 0 0 0 0 0 0