MODE 2
SIZE 11/70
LIMIT 0/25
COLOR LIMIT 4
STARS 1000/2510/4000
POWERUPS 1/1/0/0
5 20 20 5 2 20 20 2 20 20 20
5 20 5 20 2 20 2 20 20 20 20
20 5 5 20 20 2 2 20 18 18 20
20 18 20 10 20 18 20 18 11 18 20
20 5 5 20 20 2 2 20 18 18 20
5 20 5 20 2 8 2 20 20 20 20
5 20 20 5 2 20 20 2 20 20 20
20 20 20 3 20 20 3 20 20 20 20
0 20 20 20 3 8 3 20 20 20 20
20 18 18 20 3 3 20 18 18 20 20
20 18 15 18 20 18 20 18 13 18 20
20 18 18 20 3 3 20 18 18 20 20
0 20 20 20 3 8 3 20 20 20 20
20 20 20 3 20 20 3 20 20 20 20
20 20 20 2 20 20 2 1 20 20 1
20 20 20 2 8 2 20 1 8 1 20
20 18 18 20 2 2 20 20 1 1 20
18 12 18 20 18 20 9 20 18 20 20
20 18 18 20 2 2 20 20 1 1 20
20 20 20 2 8 2 20 1 8 1 20
20 20 20 2 20 20 2 1 20 20 1
20 20 20 20 9 20 20 20 20 20 20
7 7 7 7 7 7 7 7 7 7 7
7 7 7 7 7 7 7 7 7 7 0
0 0 0 0 0 0 0 0 0 0 0
0 0 0 0 0 0 0 0 0 0 0
0 0 0 0 0 0 0 0 0 0 0
0 0 0 0 0 0 0 0 0 0 0
0 0 0 0 0 0 0 0 0 0 0
0 0 0 0 0 0 0 0 0 0 0
0 0 0 0 0 0 0 0 0 0 0
0 0 0 0 0 0 0 0 0 0 0
0 0 0 0 0 0 0 0 0 0 0
0 0 0 0 0 0 0 0 0 0 0
0 0 0 0 0 0 0 0 0 0 0
0 0 0 0 0 0 0 0 0 0 0
0 0 0 0 0 0 0 0 0 0 0
0 0 0 0 0 0 0 0 0 0 0
0 0 0 0 0 0 0 0 0 0 0
0 0 0 0 0 0 0 0 0 0 0
0 0 0 0 0 0 0 0 0 0 0
0 0 0 0 0 0 0 0 0 0 0
0 0 0 0 0 0 0 0 0 0 0
0 0 0 0 0 0 0 0 0 0 0
0 0 0 0 0 0 0 0 0 0 0
0 0 0 0 0 0 0 0 0 0 0
0 0 0 0 0 0 0 0 0 0 0
0 0 0 0 0 0 0 0 0 0 0
0 0 0 0 0 0 0 0 0 0 0
0 0 0 0 0 0 0 0 0 0 0
0 0 0 0 0 0 0 0 0 0 0
0 0 0 0 0 0 0 0 0 0 0
0 0 0 0 0 0 0 0 0 0 0
0 0 0 0 0 0 0 0 0 0 0
0 0 0 0 0 0 0 0 0 0 0
0 0 0 0 0 0 0 0 0 0 0
0 0 0 0 0 0 0 0 0 0 0
0 0 0 0 0 0 0 0 0 0 0
0 0 0 0 0 0 0 0 0 0 0
0 0 0 0 0 0 0 0 0 0 0
0 0 0 0 0 0 0 0 0 0 0
0 0 0 0 0 0 0 0 0 0 0
0 0 0 0 0 0 0 0 0 0 0
0 0 0 0 0 0 0 0 0 0 0
0 0 0 0 0 0 0 0 0 0 0
0 0 0 0 0 0 0 0 0 0 0
0 0 0 0 0 0 0 0 0 0 0
0 0 0 0 0 0 0 0 0 0 0
0 0 0 0 0 0 0 0 0 0 0
0 0 0 0 0 0 0 0 0 0 0