MODE 2
SIZE 11/70
LIMIT 0/25
COLOR LIMIT 4
STARS 3500/7500/11000
POWERUPS 0/0/0/0
20 6 3 2 1 12 1 2 3 6 20
20 6 3 2 1 1 2 3 6 5 20
20 5 6 3 2 1 2 3 6 5 20
20 5 6 3 2 2 3 6 5 1 20
20 1 5 6 3 2 3 6 5 1 20
20 1 5 6 3 3 6 5 1 3 20
20 3 1 5 6 3 6 5 1 3 20
2 3 1 5 6 6 5 1 3 2 20
20 2 3 1 5 6 5 1 3 2 20
20 2 3 1 5 5 1 3 2 20 0
0 20 2 3 1 5 1 3 2 20 0
20 1 2 3 1 1 3 2 1 20 0
20 1 1 2 3 1 3 2 1 1 20
1 1 3 2 3 3 2 3 1 1 20
1 1 3 3 2 3 2 3 3 1 1
1 3 3 4 2 2 4 3 3 1 1
20 3 3 4 4 2 4 4 3 3 20
20 20 4 4 18 18 4 4 20 20 0
0 20 4 4 18 17 18 4 4 20 0
0 20 20 20 18 18 20 20 20 0 0
0 0 0 0 20 20 20 0 0 0 0
0 0 0 0 0 0 0 0 0 0 0
0 0 0 0 0 0 0 0 0 0 0
0 0 0 0 0 0 0 0 0 0 0
0 0 0 0 0 0 0 0 0 0 0
0 0 0 0 0 0 0 0 0 0 0
0 0 0 0 0 0 0 0 0 0 0
0 0 0 0 0 0 0 0 0 0 0
0 0 0 0 0 0 0 0 0 0 0
0 0 0 0 0 0 0 0 0 0 0
0 0 0 0 0 0 0 0 0 0 0
0 0 0 0 0 0 0 0 0 0 0
0 0 0 0 0 0 0 0 0 0 0
0 0 0 0 0 0 0 0 0 0 0
0 0 0 0 0 0 0 0 0 0 0
0 0 0 0 0 0 0 0 0 0 0
0 0 0 0 0 0 0 0 0 0 0
0 0 0 0 0 0 0 0 0 0 0
0 0 0 0 0 0 0 0 0 0 0
0 0 0 0 0 0 0 0 0 0 0
0 0 0 0 0 0 0 0 0 0 0
0 0 0 0 0 0 0 0 0 0 0
0 0 0 0 0 0 0 0 0 0 0
0 0 0 0 0 0 0 0 0 0 0
0 0 0 0 0 0 0 0 0 0 0
0 0 0 0 0 0 0 0 0 0 0
0 0 0 0 0 0 0 0 0 0 0
0 0 0 0 0 0 0 0 0 0 0
0 0 0 0 0 0 0 0 0 0 0
0 0 0 0 0 0 0 0 0 0 0
0 0 0 0 0 0 0 0 0 0 0
0 0 0 0 0 0 0 0 0 0 0
0 0 0 0 0 0 0 0 0 0 0
0 0 0 0 0 0 0 0 0 0 0
0 0 0 0 0 0 0 0 0 0 0
0 0 0 0 0 0 0 0 0 0 0
0 0 0 0 0 0 0 0 0 0 0
0 0 0 0 0 0 0 0 0 0 0
0 0 0 0 0 0 0 0 0 0 0
0 0 0 0 0 0 0 0 0 0 0
0 0 0 0 0 0 0 0 0 0 0
0 0 0 0 0 0 0 0 0 0 0
0 0 0 0 0 0 0 0 0 0 0
0 0 0 0 0 0 0 0 0 0 0
0 0 0 0 0 0 0 0 0 0 0
0 0 0 0 0 0 0 0 0 0 0
0 0 0 0 0 0 0 0 0 0 0
0 0 0 0 0 0 0 0 0 0 0
0 0 0 0 0 0 0 0 0 0 0
0 0 0 0 0 0 0 0 0 0 0