MODE 2
SIZE 11/70
LIMIT 0/45
COLOR LIMIT 4
STARS 2600/7200/10000
POWERUPS 0/0/0/0
7 7 7 7 7 7 7 7 7 7 7
7 7 5 7 17 17 7 7 7 7 7
7 7 5 5 7 17 7 3 7 7 7
7 5 13 5 7 7 3 3 7 7 7
7 7 5 5 7 7 3 11 3 7 7
7 7 5 7 7 7 3 3 7 7 7
20 20 20 20 20 20 20 3 7 7 7
17 17 7 7 7 1 20 20 20 20 20
7 17 7 7 7 1 1 7 7 2 7
7 7 3 7 1 12 1 7 2 2 7
7 7 3 3 7 1 1 7 2 15 2
7 3 11 3 7 1 7 7 2 2 7
7 7 3 3 17 17 2 7 7 2 7
7 7 3 7 17 2 2 20 20 20 20
20 20 20 20 20 2 15 2 7 7 7
7 7 1 7 7 2 2 7 5 7 7
7 7 1 1 7 7 2 7 5 5 7
7 1 12 1 20 20 20 5 13 5 7
7 7 1 1 7 17 17 7 5 5 7
7 7 1 7 7 17 7 7 5 7 7
20 20 20 20 20 20 20 20 20 20 20
7 7 7 7 7 7 7 7 7 7 7
0 0 0 0 0 0 0 0 0 0 0
0 0 0 0 0 0 0 0 0 0 0
0 0 0 0 0 0 0 0 0 0 0
0 0 0 0 0 0 0 0 0 0 0
0 0 0 0 0 0 0 0 0 0 0
0 0 0 0 0 0 0 0 0 0 0
0 0 0 0 0 0 0 0 0 0 0
0 0 0 0 0 0 0 0 0 0 0
0 0 0 0 0 0 0 0 0 0 0
0 0 0 0 0 0 0 0 0 0 0
0 0 0 0 0 0 0 0 0 0 0
0 0 0 0 0 0 0 0 0 0 0
0 0 0 0 0 0 0 0 0 0 0
0 0 0 0 0 0 0 0 0 0 0
0 0 0 0 0 0 0 0 0 0 0
0 0 0 0 0 0 0 0 0 0 0
0 0 0 0 0 0 0 0 0 0 0
0 0 0 0 0 0 0 0 0 0 0
0 0 0 0 0 0 0 0 0 0 0
0 0 0 0 0 0 0 0 0 0 0
0 0 0 0 0 0 0 0 0 0 0
0 0 0 0 0 0 0 0 0 0 0
0 0 0 0 0 0 0 0 0 0 0
0 0 0 0 0 0 0 0 0 0 0
0 0 0 0 0 0 0 0 0 0 0
0 0 0 0 0 0 0 0 0 0 0
0 0 0 0 0 0 0 0 0 0 0
0 0 0 0 0 0 0 0 0 0 0
0 0 0 0 0 0 0 0 0 0 0
0 0 0 0 0 0 0 0 0 0 0
0 0 0 0 0 0 0 0 0 0 0
0 0 0 0 0 0 0 0 0 0 0
0 0 0 0 0 0 0 0 0 0 0
0 0 0 0 0 0 0 0 0 0 0
0 0 0 0 0 0 0 0 0 0 0
0 0 0 0 0 0 0 0 0 0 0
0 0 0 0 0 0 0 0 0 0 0
0 0 0 0 0 0 0 0 0 0 0
0 0 0 0 0 0 0 0 0 0 0
0 0 0 0 0 0 0 0 0 0 0
0 0 0 0 0 0 0 0 0 0 0
0 0 0 0 0 0 0 0 0 0 0
0 0 0 0 0 0 0 0 0 0 0
0 0 0 0 0 0 0 0 0 0 0
0 0 0 0 0 0 0 0 0 0 0
0 0 0 0 0 0 0 0 0 0 0
0 0 0 0 0 0 0 0 0 0 0
0 0 0 0 0 0 0 0 0 0 0