MODE 2
SIZE 11/70
LIMIT 0/35
COLOR LIMIT 4
STARS 2300/3500/6000
POWERUPS 1/1/0/0
20 3 1 7 7 7 7 7 1 3 20
20 3 1 7 7 7 7 1 3 20 0
0 20 3 17 7 13 7 17 3 20 0
0 20 17 1 1 1 1 17 20 0 0
0 0 20 3 1 18 1 3 20 0 0
0 0 20 3 18 18 3 20 0 0 0
0 0 20 1 3 18 3 1 20 0 0
0 20 1 5 3 3 5 1 20 0 0
0 20 1 5 2 3 2 5 1 20 0
20 1 5 2 14 11 2 5 1 20 0
0 20 1 5 2 3 2 5 1 20 0
0 20 1 5 3 3 5 1 20 0 0
0 0 20 1 3 18 3 1 20 0 0
0 0 20 3 18 18 3 20 0 0 0
0 0 20 3 1 18 1 3 20 0 0
0 20 3 1 1 1 1 3 20 0 0
0 20 17 1 7 13 7 1 17 20 0
20 3 17 7 7 7 7 17 3 20 0
20 3 1 7 7 7 7 7 1 3 20
0 0 0 0 0 0 0 0 0 0 0
0 0 0 0 0 0 0 0 0 0 0
0 0 0 0 0 0 0 0 0 0 0
0 0 0 0 0 0 0 0 0 0 0
0 0 0 0 0 0 0 0 0 0 0
0 0 0 0 0 0 0 0 0 0 0
0 0 0 0 0 0 0 0 0 0 0
0 0 0 0 0 0 0 0 0 0 0
0 0 0 0 0 0 0 0 0 0 0
0 0 0 0 0 0 0 0 0 0 0
0 0 0 0 0 0 0 0 0 0 0
0 0 0 0 0 0 0 0 0 0 0
0 0 0 0 0 0 0 0 0 0 0
0 0 0 0 0 0 0 0 0 0 0
0 0 0 0 0 0 0 0 0 0 0
0 0 0 0 0 0 0 0 0 0 0
0 0 0 0 0 0 0 0 0 0 0
0 0 0 0 0 0 0 0 0 0 0
0 0 0 0 0 0 0 0 0 0 0
0 0 0 0 0 0 0 0 0 0 0
0 0 0 0 0 0 0 0 0 0 0
0 0 0 0 0 0 0 0 0 0 0
0 0 0 0 0 0 0 0 0 0 0
0 0 0 0 0 0 0 0 0 0 0
0 0 0 0 0 0 0 0 0 0 0
0 0 0 0 0 0 0 0 0 0 0
0 0 0 0 0 0 0 0 0 0 0
0 0 0 0 0 0 0 0 0 0 0
0 0 0 0 0 0 0 0 0 0 0
0 0 0 0 0 0 0 0 0 0 0
0 0 0 0 0 0 0 0 0 0 0
0 0 0 0 0 0 0 0 0 0 0
0 0 0 0 0 0 0 0 0 0 0
0 0 0 0 0 0 0 0 0 0 0
0 0 0 0 0 0 0 0 0 0 0
0 0 0 0 0 0 0 0 0 0 0
0 0 0 0 0 0 0 0 0 0 0
0 0 0 0 0 0 0 0 0 0 0
0 0 0 0 0 0 0 0 0 0 0
0 0 0 0 0 0 0 0 0 0 0
0 0 0 0 0 0 0 0 0 0 0
0 0 0 0 0 0 0 0 0 0 0
0 0 0 0 0 0 0 0 0 0 0
0 0 0 0 0 0 0 0 0 0 0
0 0 0 0 0 0 0 0 0 0 0
0 0 0 0 0 0 0 0 0 0 0
0 0 0 0 0 0 0 0 0 0 0
0 0 0 0 0 0 0 0 0 0 0
0 0 0 0 0 0 0 0 0 0 0
0 0 0 0 0 0 0 0 0 0 0
0 0 0 0 0 0 0 0 0 0 0