MODE 2
SIZE 11/70
LIMIT 0/40
COLOR LIMIT 4
STARS 1800/4200/8200
POWERUPS 1/0/1/0
17 17 0 4 4 0 0 4 4 0 17
17 17 0 14 0 0 0 14 0 17 17
0 17 17 5 5 5 5 5 5 17 17
0 5 1 1 1 5 1 1 1 5 0
0 20 1 3 3 1 1 3 3 1 20
5 20 3 2 3 20 3 2 3 20 5
5 1 20 2 20 20 20 20 2 20 1
1 3 20 17 2 3 2 17 20 3 1
5 1 3 2 2 2 2 2 2 3 1
5 1 3 2 17 11 17 2 3 1 5
4 20 20 20 20 2 2 20 20 20 20
4 5 1 3 2 2 2 3 1 5 4
6 4 5 1 3 2 2 3 1 5 4
6 4 5 1 3 8 3 1 5 4 6
1 20 20 20 20 20 20 20 20 20 6
1 6 4 5 1 13 1 5 4 6 1
3 1 6 4 5 1 1 5 4 6 1
3 1 6 4 5 1 5 4 6 1 3
0 3 1 6 4 5 5 4 6 1 3
0 3 18 6 4 18 4 6 18 3 0
0 0 3 0 6 0 0 6 0 3 0
0 0 0 0 0 0 0 0 0 0 0
0 0 0 0 0 0 0 0 0 0 0
0 0 0 0 0 0 0 0 0 0 0
0 0 0 0 0 0 0 0 0 0 0
0 0 0 0 0 0 0 0 0 0 0
0 0 0 0 0 0 0 0 0 0 0
0 0 0 0 0 0 0 0 0 0 0
0 0 0 0 0 0 0 0 0 0 0
0 0 0 0 0 0 0 0 0 0 0
0 0 0 0 0 0 0 0 0 0 0
0 0 0 0 0 0 0 0 0 0 0
0 0 0 0 0 0 0 0 0 0 0
0 0 0 0 0 0 0 0 0 0 0
0 0 0 0 0 0 0 0 0 0 0
0 0 0 0 0 0 0 0 0 0 0
0 0 0 0 0 0 0 0 0 0 0
0 0 0 0 0 0 0 0 0 0 0
0 0 0 0 0 0 0 0 0 0 0
0 0 0 0 0 0 0 0 0 0 0
0 0 0 0 0 0 0 0 0 0 0
0 0 0 0 0 0 0 0 0 0 0
0 0 0 0 0 0 0 0 0 0 0
0 0 0 0 0 0 0 0 0 0 0
0 0 0 0 0 0 0 0 0 0 0
0 0 0 0 0 0 0 0 0 0 0
0 0 0 0 0 0 0 0 0 0 0
0 0 0 0 0 0 0 0 0 0 0
0 0 0 0 0 0 0 0 0 0 0
0 0 0 0 0 0 0 0 0 0 0
0 0 0 0 0 0 0 0 0 0 0
0 0 0 0 0 0 0 0 0 0 0
0 0 0 0 0 0 0 0 0 0 0
0 0 0 0 0 0 0 0 0 0 0
0 0 0 0 0 0 0 0 0 0 0
0 0 0 0 0 0 0 0 0 0 0
0 0 0 0 0 0 0 0 0 0 0
0 0 0 0 0 0 0 0 0 0 0
0 0 0 0 0 0 0 0 0 0 0
0 0 0 0 0 0 0 0 0 0 0
0 0 0 0 0 0 0 0 0 0 0
0 0 0 0 0 0 0 0 0 0 0
0 0 0 0 0 0 0 0 0 0 0
0 0 0 0 0 0 0 0 0 0 0
0 0 0 0 0 0 0 0 0 0 0
0 0 0 0 0 0 0 0 0 0 0
0 0 0 0 0 0 0 0 0 0 0
0 0 0 0 0 0 0 0 0 0 0
0 0 0 0 0 0 0 0 0 0 0
0 0 0 0 0 0 0 0 0 0 0