MODE 2
SIZE 11/70
LIMIT 0/35
COLOR LIMIT 4
STARS 1000/2800/5500
POWERUPS 1/0/1/0
3 3 3 3 18 18 18 3 3 3 3
0 17 0 3 18 18 3 0 17 0 0
1 1 1 1 1 3 1 1 1 1 1
0 17 0 3 20 20 3 0 17 0 0
3 3 3 3 20 18 20 3 3 3 3
0 17 0 20 3 16 20 0 17 0 0
1 1 1 1 20 18 20 1 1 1 1
0 17 0 1 20 20 1 0 17 0 0
3 3 3 3 3 1 3 3 3 3 3
0 17 0 1 20 20 1 0 17 0 0
1 1 1 1 20 18 20 1 1 1 1
0 17 0 20 11 5 20 0 17 0 0
2 2 2 2 20 18 20 2 2 2 2
0 17 0 2 20 20 2 0 17 0 0
5 5 5 5 5 2 5 5 5 5 5
0 17 0 2 20 20 2 0 17 0 0
2 2 2 2 20 18 20 2 2 2 2
0 17 0 20 12 13 20 0 17 0 0
4 4 4 4 20 18 20 4 4 4 4
0 17 0 4 20 20 4 0 17 0 0
1 1 1 1 1 4 1 1 1 1 1
0 17 0 4 18 18 4 0 17 0 0
4 4 4 4 18 18 18 4 4 4 4
0 0 0 0 0 0 0 0 0 0 0
0 0 0 0 0 0 0 0 0 0 0
0 0 0 0 0 0 0 0 0 0 0
0 0 0 0 0 0 0 0 0 0 0
0 0 0 0 0 0 0 0 0 0 0
0 0 0 0 0 0 0 0 0 0 0
0 0 0 0 0 0 0 0 0 0 0
0 0 0 0 0 0 0 0 0 0 0
0 0 0 0 0 0 0 0 0 0 0
0 0 0 0 0 0 0 0 0 0 0
0 0 0 0 0 0 0 0 0 0 0
0 0 0 0 0 0 0 0 0 0 0
0 0 0 0 0 0 0 0 0 0 0
0 0 0 0 0 0 0 0 0 0 0
0 0 0 0 0 0 0 0 0 0 0
0 0 0 0 0 0 0 0 0 0 0
0 0 0 0 0 0 0 0 0 0 0
0 0 0 0 0 0 0 0 0 0 0
0 0 0 0 0 0 0 0 0 0 0
0 0 0 0 0 0 0 0 0 0 0
0 0 0 0 0 0 0 0 0 0 0
0 0 0 0 0 0 0 0 0 0 0
0 0 0 0 0 0 0 0 0 0 0
0 0 0 0 0 0 0 0 0 0 0
0 0 0 0 0 0 0 0 0 0 0
0 0 0 0 0 0 0 0 0 0 0
0 0 0 0 0 0 0 0 0 0 0
0 0 0 0 0 0 0 0 0 0 0
0 0 0 0 0 0 0 0 0 0 0
0 0 0 0 0 0 0 0 0 0 0
0 0 0 0 0 0 0 0 0 0 0
0 0 0 0 0 0 0 0 0 0 0
0 0 0 0 0 0 0 0 0 0 0
0 0 0 0 0 0 0 0 0 0 0
0 0 0 0 0 0 0 0 0 0 0
0 0 0 0 0 0 0 0 0 0 0
0 0 0 0 0 0 0 0 0 0 0
0 0 0 0 0 0 0 0 0 0 0
0 0 0 0 0 0 0 0 0 0 0
0 0 0 0 0 0 0 0 0 0 0
0 0 0 0 0 0 0 0 0 0 0
0 0 0 0 0 0 0 0 0 0 0
0 0 0 0 0 0 0 0 0 0 0
0 0 0 0 0 0 0 0 0 0 0
0 0 0 0 0 0 0 0 0 0 0
0 0 0 0 0 0 0 0 0 0 0
0 0 0 0 0 0 0 0 0 0 0