MODE 2
SIZE 11/70
LIMIT 0/40
COLOR LIMIT 4
STARS 1000/3100/5500
POWERUPS 0/0/0/0
5 5 3 1 4 5 4 1 3 5 5
5 3 1 4 2 2 4 1 3 5 0
5 3 1 4 20 20 20 4 1 3 5
3 1 4 20 2 2 20 4 1 3 0
3 1 6 20 2 1 2 20 6 1 3
1 6 20 2 1 1 2 20 6 1 0
0 6 20 3 18 8 18 3 20 6 0
6 20 3 1 4 4 1 3 20 6 0
0 20 3 1 4 13 4 1 3 20 0
20 3 1 1 4 4 1 1 3 20 0
20 3 6 18 20 3 20 18 6 3 20
3 6 1 20 3 3 20 1 6 3 0
2 6 1 3 3 14 3 3 1 6 2
2 6 1 20 3 3 20 1 6 2 0
0 2 6 20 20 3 20 20 6 2 0
0 2 20 7 20 20 7 20 2 0 0
0 0 3 7 7 20 7 7 3 0 0
0 0 3 7 7 7 7 3 0 0 0
0 0 0 3 7 7 7 3 0 0 0
0 0 0 1 7 7 1 0 0 0 0
0 0 0 0 1 7 1 0 0 0 0
0 0 0 0 1 1 0 0 0 0 0
0 0 0 0 0 1 0 0 0 0 0
0 0 0 0 0 0 0 0 0 0 0
0 0 0 0 0 0 0 0 0 0 0
0 0 0 0 0 0 0 0 0 0 0
0 0 0 0 0 0 0 0 0 0 0
0 0 0 0 0 0 0 0 0 0 0
0 0 0 0 0 0 0 0 0 0 0
0 0 0 0 0 0 0 0 0 0 0
0 0 0 0 0 0 0 0 0 0 0
0 0 0 0 0 0 0 0 0 0 0
0 0 0 0 0 0 0 0 0 0 0
0 0 0 0 0 0 0 0 0 0 0
0 0 0 0 0 0 0 0 0 0 0
0 0 0 0 0 0 0 0 0 0 0
0 0 0 0 0 0 0 0 0 0 0
0 0 0 0 0 0 0 0 0 0 0
0 0 0 0 0 0 0 0 0 0 0
0 0 0 0 0 0 0 0 0 0 0
0 0 0 0 0 0 0 0 0 0 0
0 0 0 0 0 0 0 0 0 0 0
0 0 0 0 0 0 0 0 0 0 0
0 0 0 0 0 0 0 0 0 0 0
0 0 0 0 0 0 0 0 0 0 0
0 0 0 0 0 0 0 0 0 0 0
0 0 0 0 0 0 0 0 0 0 0
0 0 0 0 0 0 0 0 0 0 0
0 0 0 0 0 0 0 0 0 0 0
0 0 0 0 0 0 0 0 0 0 0
0 0 0 0 0 0 0 0 0 0 0
0 0 0 0 0 0 0 0 0 0 0
0 0 0 0 0 0 0 0 0 0 0
0 0 0 0 0 0 0 0 0 0 0
0 0 0 0 0 0 0 0 0 0 0
0 0 0 0 0 0 0 0 0 0 0
0 0 0 0 0 0 0 0 0 0 0
0 0 0 0 0 0 0 0 0 0 0
0 0 0 0 0 0 0 0 0 0 0
0 0 0 0 0 0 0 0 0 0 0
0 0 0 0 0 0 0 0 0 0 0
0 0 0 0 0 0 0 0 0 0 0
0 0 0 0 0 0 0 0 0 0 0
0 0 0 0 0 0 0 0 0 0 0
0 0 0 0 0 0 0 0 0 0 0
0 0 0 0 0 0 0 0 0 0 0
0 0 0 0 0 0 0 0 0 0 0
0 0 0 0 0 0 0 0 0 0 0
0 0 0 0 0 0 0 0 0 0 0
0 0 0 0 0 0 0 0 0 0 0