MODE 2
SIZE 11/70
LIMIT 0/45
COLOR LIMIT 4
STARS 2100/4200/8000
POWERUPS 0/0/0/0
7 7 3 7 7 7 7 7 7 3 7
7 3 3 7 7 3 7 7 3 3 7
7 3 15 3 7 7 7 7 3 11 3
3 3 3 3 7 7 7 3 3 3 3
7 7 7 7 7 7 7 7 7 7 7
7 7 7 20 20 20 20 20 7 7 7
7 7 7 7 20 3 3 20 7 7 7
7 7 7 7 20 10 20 7 7 7 7
7 7 20 7 7 20 20 7 7 20 7
7 20 20 7 7 20 7 7 20 20 7
7 20 13 20 7 7 7 7 20 14 20
20 20 20 20 7 7 7 20 20 20 20
7 7 7 7 7 7 7 7 7 7 7
7 7 7 7 20 20 20 20 7 7 7
7 7 7 7 7 20 12 20 7 7 7
7 7 7 7 7 20 20 7 7 7 7
7 7 20 7 7 7 20 7 7 20 7
7 20 20 7 7 7 7 7 20 20 7
7 20 8 20 7 7 7 7 20 8 20
20 20 20 20 7 7 7 20 20 20 20
7 7 7 7 7 7 7 7 7 7 7
7 7 7 7 7 7 7 7 7 7 7
0 0 0 0 0 0 0 0 0 0 0
0 0 0 0 0 0 0 0 0 0 0
0 0 0 0 0 0 0 0 0 0 0
0 0 0 0 0 0 0 0 0 0 0
0 0 0 0 0 0 0 0 0 0 0
0 0 0 0 0 0 0 0 0 0 0
0 0 0 0 0 0 0 0 0 0 0
0 0 0 0 0 0 0 0 0 0 0
0 0 0 0 0 0 0 0 0 0 0
0 0 0 0 0 0 0 0 0 0 0
0 0 0 0 0 0 0 0 0 0 0
0 0 0 0 0 0 0 0 0 0 0
0 0 0 0 0 0 0 0 0 0 0
0 0 0 0 0 0 0 0 0 0 0
0 0 0 0 0 0 0 0 0 0 0
0 0 0 0 0 0 0 0 0 0 0
0 0 0 0 0 0 0 0 0 0 0
0 0 0 0 0 0 0 0 0 0 0
0 0 0 0 0 0 0 0 0 0 0
0 0 0 0 0 0 0 0 0 0 0
0 0 0 0 0 0 0 0 0 0 0
0 0 0 0 0 0 0 0 0 0 0
0 0 0 0 0 0 0 0 0 0 0
0 0 0 0 0 0 0 0 0 0 0
0 0 0 0 0 0 0 0 0 0 0
0 0 0 0 0 0 0 0 0 0 0
0 0 0 0 0 0 0 0 0 0 0
0 0 0 0 0 0 0 0 0 0 0
0 0 0 0 0 0 0 0 0 0 0
0 0 0 0 0 0 0 0 0 0 0
0 0 0 0 0 0 0 0 0 0 0
0 0 0 0 0 0 0 0 0 0 0
0 0 0 0 0 0 0 0 0 0 0
0 0 0 0 0 0 0 0 0 0 0
0 0 0 0 0 0 0 0 0 0 0
0 0 0 0 0 0 0 0 0 0 0
0 0 0 0 0 0 0 0 0 0 0
0 0 0 0 0 0 0 0 0 0 0
0 0 0 0 0 0 0 0 0 0 0
0 0 0 0 0 0 0 0 0 0 0
0 0 0 0 0 0 0 0 0 0 0
0 0 0 0 0 0 0 0 0 0 0
0 0 0 0 0 0 0 0 0 0 0
0 0 0 0 0 0 0 0 0 0 0
0 0 0 0 0 0 0 0 0 0 0
0 0 0 0 0 0 0 0 0 0 0
0 0 0 0 0 0 0 0 0 0 0
0 0 0 0 0 0 0 0 0 0 0