MODE 2
SIZE 11/70
LIMIT 0/40
COLOR LIMIT 4
STARS 1200/2800/5500
POWERUPS 1/1/0/0
0 0 2 20 20 20 20 20 2 0 0
0 2 20 20 3 3 20 20 2 0 0
1 2 20 3 20 5 20 3 20 2 1
2 20 3 5 18 12 5 3 20 2 0
2 1 20 3 20 5 20 3 20 1 2
20 1 20 20 3 3 20 20 1 20 0
0 20 1 20 20 20 20 20 1 20 0
20 1 20 20 3 3 20 20 1 20 0
3 1 20 3 20 5 20 3 20 1 3
1 20 3 5 16 18 5 3 20 1 0
1 3 20 3 20 5 20 3 20 3 1
20 3 20 20 3 3 20 20 3 20 0
0 20 3 20 20 20 20 20 3 20 0
20 3 20 20 3 3 20 20 3 20 0
2 3 20 3 20 5 20 3 20 3 2
2 20 3 5 18 11 5 3 20 2 0
3 2 20 3 20 5 20 3 20 2 3
20 2 20 20 3 3 20 20 2 20 0
0 20 2 20 20 20 20 20 2 20 0
0 20 0 0 0 0 0 0 20 0 0
0 0 0 0 0 0 0 0 0 0 0
0 0 0 0 0 0 0 0 0 0 0
0 0 0 0 0 0 0 0 0 0 0
0 0 0 0 0 0 0 0 0 0 0
0 0 0 0 0 0 0 0 0 0 0
0 0 0 0 0 0 0 0 0 0 0
0 0 0 0 0 0 0 0 0 0 0
0 0 0 0 0 0 0 0 0 0 0
0 0 0 0 0 0 0 0 0 0 0
0 0 0 0 0 0 0 0 0 0 0
0 0 0 0 0 0 0 0 0 0 0
0 0 0 0 0 0 0 0 0 0 0
0 0 0 0 0 0 0 0 0 0 0
0 0 0 0 0 0 0 0 0 0 0
0 0 0 0 0 0 0 0 0 0 0
0 0 0 0 0 0 0 0 0 0 0
0 0 0 0 0 0 0 0 0 0 0
0 0 0 0 0 0 0 0 0 0 0
0 0 0 0 0 0 0 0 0 0 0
0 0 0 0 0 0 0 0 0 0 0
0 0 0 0 0 0 0 0 0 0 0
0 0 0 0 0 0 0 0 0 0 0
0 0 0 0 0 0 0 0 0 0 0
0 0 0 0 0 0 0 0 0 0 0
0 0 0 0 0 0 0 0 0 0 0
0 0 0 0 0 0 0 0 0 0 0
0 0 0 0 0 0 0 0 0 0 0
0 0 0 0 0 0 0 0 0 0 0
0 0 0 0 0 0 0 0 0 0 0
0 0 0 0 0 0 0 0 0 0 0
0 0 0 0 0 0 0 0 0 0 0
0 0 0 0 0 0 0 0 0 0 0
0 0 0 0 0 0 0 0 0 0 0
0 0 0 0 0 0 0 0 0 0 0
0 0 0 0 0 0 0 0 0 0 0
0 0 0 0 0 0 0 0 0 0 0
0 0 0 0 0 0 0 0 0 0 0
0 0 0 0 0 0 0 0 0 0 0
0 0 0 0 0 0 0 0 0 0 0
0 0 0 0 0 0 0 0 0 0 0
0 0 0 0 0 0 0 0 0 0 0
0 0 0 0 0 0 0 0 0 0 0
0 0 0 0 0 0 0 0 0 0 0
0 0 0 0 0 0 0 0 0 0 0
0 0 0 0 0 0 0 0 0 0 0
0 0 0 0 0 0 0 0 0 0 0
0 0 0 0 0 0 0 0 0 0 0
0 0 0 0 0 0 0 0 0 0 0
0 0 0 0 0 0 0 0 0 0 0
0 0 0 0 0 0 0 0 0 0 0