MODE 2
SIZE 11/70
LIMIT 0/35
COLOR LIMIT 4
STARS 2500/5200/8000
POWERUPS 0/0/0/0
17 17 17 17 17 17 17 17 17 17 17
0 1 1 3 3 3 3 1 1 0 0
0 20 1 3 3 2 3 3 1 20 0
1 20 18 3 18 18 3 18 20 1 0
1 1 3 18 2 13 2 18 3 1 1
1 20 3 2 2 2 2 3 20 1 0
1 3 20 18 2 5 2 18 20 3 1
3 3 2 18 5 5 18 2 3 3 0
3 3 20 2 18 11 18 2 20 3 3
3 2 20 5 18 18 5 20 2 3 0
0 2 2 5 5 6 5 5 2 2 0
18 2 20 5 18 18 5 20 2 18 0
0 18 5 20 6 12 6 20 5 18 0
2 5 5 6 6 6 6 5 5 2 0
0 5 5 20 6 0 6 20 5 5 0
5 5 6 20 0 0 20 6 5 5 0
0 5 6 6 0 0 0 6 6 5 0
5 18 6 0 0 0 0 6 18 5 0
0 6 18 0 0 0 0 0 18 6 0
6 6 0 0 0 0 0 0 6 6 0
0 6 0 0 0 0 0 0 0 6 0
6 0 0 0 0 0 0 0 0 6 0
0 0 0 0 0 0 0 0 0 0 0
0 0 0 0 0 0 0 0 0 0 0
0 0 0 0 0 0 0 0 0 0 0
0 0 0 0 0 0 0 0 0 0 0
0 0 0 0 0 0 0 0 0 0 0
0 0 0 0 0 0 0 0 0 0 0
0 0 0 0 0 0 0 0 0 0 0
0 0 0 0 0 0 0 0 0 0 0
0 0 0 0 0 0 0 0 0 0 0
0 0 0 0 0 0 0 0 0 0 0
0 0 0 0 0 0 0 0 0 0 0
0 0 0 0 0 0 0 0 0 0 0
0 0 0 0 0 0 0 0 0 0 0
0 0 0 0 0 0 0 0 0 0 0
0 0 0 0 0 0 0 0 0 0 0
0 0 0 0 0 0 0 0 0 0 0
0 0 0 0 0 0 0 0 0 0 0
0 0 0 0 0 0 0 0 0 0 0
0 0 0 0 0 0 0 0 0 0 0
0 0 0 0 0 0 0 0 0 0 0
0 0 0 0 0 0 0 0 0 0 0
0 0 0 0 0 0 0 0 0 0 0
0 0 0 0 0 0 0 0 0 0 0
0 0 0 0 0 0 0 0 0 0 0
0 0 0 0 0 0 0 0 0 0 0
0 0 0 0 0 0 0 0 0 0 0
0 0 0 0 0 0 0 0 0 0 0
0 0 0 0 0 0 0 0 0 0 0
0 0 0 0 0 0 0 0 0 0 0
0 0 0 0 0 0 0 0 0 0 0
0 0 0 0 0 0 0 0 0 0 0
0 0 0 0 0 0 0 0 0 0 0
0 0 0 0 0 0 0 0 0 0 0
0 0 0 0 0 0 0 0 0 0 0
0 0 0 0 0 0 0 0 0 0 0
0 0 0 0 0 0 0 0 0 0 0
0 0 0 0 0 0 0 0 0 0 0
0 0 0 0 0 0 0 0 0 0 0
0 0 0 0 0 0 0 0 0 0 0
0 0 0 0 0 0 0 0 0 0 0
0 0 0 0 0 0 0 0 0 0 0
0 0 0 0 0 0 0 0 0 0 0
0 0 0 0 0 0 0 0 0 0 0
0 0 0 0 0 0 0 0 0 0 0
0 0 0 0 0 0 0 0 0 0 0
0 0 0 0 0 0 0 0 0 0 0
0 0 0 0 0 0 0 0 0 0 0
0 0 0 0 0 0 0 0 0 0 0