MODE 2
SIZE 11/70
LIMIT 0/35
COLOR LIMIT 4
STARS 1200/3200/5200
POWERUPS 0/0/0/0
17 17 17 17 17 17 17 17 17 17 17
0 1 1 2 17 17 2 1 1 0 0
0 0 1 2 2 17 2 2 1 0 0
0 0 20 20 20 20 20 20 0 0 0
0 0 2 2 1 12 1 2 2 0 0
0 2 2 1 1 1 1 2 2 0 0
0 20 20 20 20 20 20 20 20 20 0
2 2 20 3 1 1 3 20 2 2 0
2 2 20 3 4 13 4 3 20 2 2
2 2 20 3 1 1 3 20 2 2 0
0 20 20 20 20 20 20 20 20 20 0
0 2 2 1 1 1 1 2 2 0 0
0 0 2 2 1 3 1 2 2 0 0
0 0 2 2 3 3 2 2 0 0 0
0 0 1 20 20 4 20 20 1 0 0
0 1 1 2 2 2 2 1 1 0 0
0 1 1 3 2 8 2 3 1 1 0
20 20 3 4 20 20 4 3 20 20 0
0 1 1 3 2 11 2 3 1 1 0
0 1 1 2 2 2 2 1 1 0 0
0 0 1 20 20 10 20 20 1 0 0
0 0 2 2 3 3 2 2 0 0 0
0 0 2 2 1 3 1 2 2 0 0
0 2 2 1 1 1 1 2 2 0 0
0 20 20 0 20 20 20 0 20 20 0
2 2 0 0 1 1 0 0 2 2 0
0 0 0 0 0 0 0 0 0 0 0
0 0 0 0 0 0 0 0 0 0 0
0 0 0 0 0 0 0 0 0 0 0
0 0 0 0 0 0 0 0 0 0 0
0 0 0 0 0 0 0 0 0 0 0
0 0 0 0 0 0 0 0 0 0 0
0 0 0 0 0 0 0 0 0 0 0
0 0 0 0 0 0 0 0 0 0 0
0 0 0 0 0 0 0 0 0 0 0
0 0 0 0 0 0 0 0 0 0 0
0 0 0 0 0 0 0 0 0 0 0
0 0 0 0 0 0 0 0 0 0 0
0 0 0 0 0 0 0 0 0 0 0
0 0 0 0 0 0 0 0 0 0 0
0 0 0 0 0 0 0 0 0 0 0
0 0 0 0 0 0 0 0 0 0 0
0 0 0 0 0 0 0 0 0 0 0
0 0 0 0 0 0 0 0 0 0 0
0 0 0 0 0 0 0 0 0 0 0
0 0 0 0 0 0 0 0 0 0 0
0 0 0 0 0 0 0 0 0 0 0
0 0 0 0 0 0 0 0 0 0 0
0 0 0 0 0 0 0 0 0 0 0
0 0 0 0 0 0 0 0 0 0 0
0 0 0 0 0 0 0 0 0 0 0
0 0 0 0 0 0 0 0 0 0 0
0 0 0 0 0 0 0 0 0 0 0
0 0 0 0 0 0 0 0 0 0 0
0 0 0 0 0 0 0 0 0 0 0
0 0 0 0 0 0 0 0 0 0 0
0 0 0 0 0 0 0 0 0 0 0
0 0 0 0 0 0 0 0 0 0 0
0 0 0 0 0 0 0 0 0 0 0
0 0 0 0 0 0 0 0 0 0 0
0 0 0 0 0 0 0 0 0 0 0
0 0 0 0 0 0 0 0 0 0 0
0 0 0 0 0 0 0 0 0 0 0
0 0 0 0 0 0 0 0 0 0 0
0 0 0 0 0 0 0 0 0 0 0
0 0 0 0 0 0 0 0 0 0 0
0 0 0 0 0 0 0 0 0 0 0
0 0 0 0 0 0 0 0 0 0 0
0 0 0 0 0 0 0 0 0 0 0
0 0 0 0 0 0 0 0 0 0 0