MODE 2
SIZE 11/70
LIMIT 0/45
COLOR LIMIT 4
STARS 1800/3200/6200
POWERUPS 0/0/0/0
3 0 0 5 17 17 17 5 0 0 3
20 0 5 17 5 15 17 5 0 20 0
0 20 5 20 17 1 17 20 5 20 0
0 5 1 20 1 1 20 1 5 0 0
0 5 1 3 1 13 1 3 1 5 0
5 18 3 1 2 2 1 3 18 5 0
5 1 20 20 2 2 2 20 20 1 5
1 3 1 1 1 1 1 1 3 1 0
1 3 20 5 5 5 5 5 20 3 1
3 20 3 3 3 3 3 3 20 3 0
3 3 1 5 6 20 6 5 1 3 3
0 1 5 6 18 18 6 5 1 0 0
0 1 5 6 18 3 18 6 5 1 0
1 5 0 0 3 18 0 0 5 1 0
1 0 0 20 3 12 3 20 0 0 1
0 0 20 3 3 3 3 20 0 0 0
0 0 20 20 20 0 20 20 20 0 0
7 7 7 7 7 7 7 7 7 7 0
7 7 7 7 7 7 7 7 7 7 7
7 7 7 7 7 7 7 7 7 7 0
0 0 0 0 0 0 0 0 0 0 0
0 0 0 0 0 0 0 0 0 0 0
0 0 0 0 0 0 0 0 0 0 0
0 0 0 0 0 0 0 0 0 0 0
0 0 0 0 0 0 0 0 0 0 0
0 0 0 0 0 0 0 0 0 0 0
0 0 0 0 0 0 0 0 0 0 0
0 0 0 0 0 0 0 0 0 0 0
0 0 0 0 0 0 0 0 0 0 0
0 0 0 0 0 0 0 0 0 0 0
0 0 0 0 0 0 0 0 0 0 0
0 0 0 0 0 0 0 0 0 0 0
0 0 0 0 0 0 0 0 0 0 0
0 0 0 0 0 0 0 0 0 0 0
0 0 0 0 0 0 0 0 0 0 0
0 0 0 0 0 0 0 0 0 0 0
0 0 0 0 0 0 0 0 0 0 0
0 0 0 0 0 0 0 0 0 0 0
0 0 0 0 0 0 0 0 0 0 0
0 0 0 0 0 0 0 0 0 0 0
0 0 0 0 0 0 0 0 0 0 0
0 0 0 0 0 0 0 0 0 0 0
0 0 0 0 0 0 0 0 0 0 0
0 0 0 0 0 0 0 0 0 0 0
0 0 0 0 0 0 0 0 0 0 0
0 0 0 0 0 0 0 0 0 0 0
0 0 0 0 0 0 0 0 0 0 0
0 0 0 0 0 0 0 0 0 0 0
0 0 0 0 0 0 0 0 0 0 0
0 0 0 0 0 0 0 0 0 0 0
0 0 0 0 0 0 0 0 0 0 0
0 0 0 0 0 0 0 0 0 0 0
0 0 0 0 0 0 0 0 0 0 0
0 0 0 0 0 0 0 0 0 0 0
0 0 0 0 0 0 0 0 0 0 0
0 0 0 0 0 0 0 0 0 0 0
0 0 0 0 0 0 0 0 0 0 0
0 0 0 0 0 0 0 0 0 0 0
0 0 0 0 0 0 0 0 0 0 0
0 0 0 0 0 0 0 0 0 0 0
0 0 0 0 0 0 0 0 0 0 0
0 0 0 0 0 0 0 0 0 0 0
0 0 0 0 0 0 0 0 0 0 0
0 0 0 0 0 0 0 0 0 0 0
0 0 0 0 0 0 0 0 0 0 0
0 0 0 0 0 0 0 0 0 0 0
0 0 0 0 0 0 0 0 0 0 0
0 0 0 0 0 0 0 0 0 0 0
0 0 0 0 0 0 0 0 0 0 0
0 0 0 0 0 0 0 0 0 0 0