MODE 2
SIZE 11/70
LIMIT 0/30
COLOR LIMIT 4
STARS 2200/3800/7000
POWERUPS 1/0/1/0
5 17 17 17 5 5 5 17 17 17 5
5 1 3 2 1 1 2 3 1 5 0
1 5 1 3 2 13 2 3 1 5 1
1 5 1 3 2 2 3 1 5 1 0
3 1 5 1 3 11 3 1 5 1 3
3 1 17 1 3 3 1 17 1 3 0
2 3 1 5 1 3 1 5 1 3 2
2 3 3 5 17 17 5 3 3 2 4
4 2 3 1 5 12 5 1 3 2 4
4 2 3 1 17 17 1 3 2 4 1
1 4 2 3 1 5 1 3 2 4 1
1 4 2 3 1 1 3 2 4 1 0
0 1 4 2 3 18 3 2 4 1 0
3 1 4 2 18 18 2 4 1 3 0
3 2 1 4 1 3 1 4 1 2 3
2 5 1 1 17 17 1 1 5 2 0
2 5 6 1 3 2 3 1 6 5 2
5 6 3 3 2 2 3 3 6 5 0
5 6 1 1 1 13 1 1 1 6 5
6 0 0 0 1 1 0 0 0 6 0
6 0 0 0 0 1 0 0 0 0 6
0 0 0 0 0 0 0 0 0 0 0
0 0 0 0 0 0 0 0 0 0 0
0 0 0 0 0 0 0 0 0 0 0
0 0 0 0 0 0 0 0 0 0 0
0 0 0 0 0 0 0 0 0 0 0
0 0 0 0 0 0 0 0 0 0 0
0 0 0 0 0 0 0 0 0 0 0
0 0 0 0 0 0 0 0 0 0 0
0 0 0 0 0 0 0 0 0 0 0
0 0 0 0 0 0 0 0 0 0 0
0 0 0 0 0 0 0 0 0 0 0
0 0 0 0 0 0 0 0 0 0 0
0 0 0 0 0 0 0 0 0 0 0
0 0 0 0 0 0 0 0 0 0 0
0 0 0 0 0 0 0 0 0 0 0
0 0 0 0 0 0 0 0 0 0 0
0 0 0 0 0 0 0 0 0 0 0
0 0 0 0 0 0 0 0 0 0 0
0 0 0 0 0 0 0 0 0 0 0
0 0 0 0 0 0 0 0 0 0 0
0 0 0 0 0 0 0 0 0 0 0
0 0 0 0 0 0 0 0 0 0 0
0 0 0 0 0 0 0 0 0 0 0
0 0 0 0 0 0 0 0 0 0 0
0 0 0 0 0 0 0 0 0 0 0
0 0 0 0 0 0 0 0 0 0 0
0 0 0 0 0 0 0 0 0 0 0
0 0 0 0 0 0 0 0 0 0 0
0 0 0 0 0 0 0 0 0 0 0
0 0 0 0 0 0 0 0 0 0 0
0 0 0 0 0 0 0 0 0 0 0
0 0 0 0 0 0 0 0 0 0 0
0 0 0 0 0 0 0 0 0 0 0
0 0 0 0 0 0 0 0 0 0 0
0 0 0 0 0 0 0 0 0 0 0
0 0 0 0 0 0 0 0 0 0 0
0 0 0 0 0 0 0 0 0 0 0
0 0 0 0 0 0 0 0 0 0 0
0 0 0 0 0 0 0 0 0 0 0
0 0 0 0 0 0 0 0 0 0 0
0 0 0 0 0 0 0 0 0 0 0
0 0 0 0 0 0 0 0 0 0 0
0 0 0 0 0 0 0 0 0 0 0
0 0 0 0 0 0 0 0 0 0 0
0 0 0 0 0 0 0 0 0 0 0
0 0 0 0 0 0 0 0 0 0 0
0 0 0 0 0 0 0 0 0 0 0
0 0 0 0 0 0 0 0 0 0 0
0 0 0 0 0 0 0 0 0 0 0