MODE 2
SIZE 11/70
LIMIT 0/35
COLOR LIMIT 4
STARS 1900/3200/5400
POWERUPS 1/1/0/0
17 17 17 17 17 17 17 17 17 17 17
1 1 1 20 20 20 20 20 20 1 1
3 3 3 20 20 2 13 2 20 3 3
1 1 20 2 18 18 2 20 1 1 1
0 0 20 2 2 2 20 20 0 0 0
0 0 20 3 3 3 20 20 0 0 0
3 3 3 20 3 18 11 3 20 3 3
1 1 1 20 3 3 3 3 20 1 1
3 3 3 20 20 1 1 1 20 3 3
0 0 20 1 18 18 1 20 0 0 0
0 0 20 1 1 1 20 20 0 0 0
1 1 20 5 5 5 20 20 1 1 1
3 3 3 20 5 13 18 5 20 3 3
1 1 1 20 20 5 5 5 20 1 1
0 0 0 20 20 3 3 3 20 0 0
0 0 20 3 18 18 3 20 0 0 0
3 3 20 3 3 3 20 20 3 3 3
1 1 20 1 1 1 20 20 1 1 1
3 3 3 20 1 18 12 1 20 3 3
0 0 0 20 20 1 1 1 20 0 0
0 0 0 0 20 18 18 18 18 20 0
1 1 1 20 1 1 1 1 20 1 1
3 3 3 20 3 3 3 3 20 3 3
1 1 20 1 1 1 1 20 1 1 1
0 0 0 0 0 0 0 0 0 0 0
0 0 0 0 0 0 0 0 0 0 0
0 0 0 0 0 0 0 0 0 0 0
0 0 0 0 0 0 0 0 0 0 0
0 0 0 0 0 0 0 0 0 0 0
0 0 0 0 0 0 0 0 0 0 0
0 0 0 0 0 0 0 0 0 0 0
0 0 0 0 0 0 0 0 0 0 0
0 0 0 0 0 0 0 0 0 0 0
0 0 0 0 0 0 0 0 0 0 0
0 0 0 0 0 0 0 0 0 0 0
0 0 0 0 0 0 0 0 0 0 0
0 0 0 0 0 0 0 0 0 0 0
0 0 0 0 0 0 0 0 0 0 0
0 0 0 0 0 0 0 0 0 0 0
0 0 0 0 0 0 0 0 0 0 0
0 0 0 0 0 0 0 0 0 0 0
0 0 0 0 0 0 0 0 0 0 0
0 0 0 0 0 0 0 0 0 0 0
0 0 0 0 0 0 0 0 0 0 0
0 0 0 0 0 0 0 0 0 0 0
0 0 0 0 0 0 0 0 0 0 0
0 0 0 0 0 0 0 0 0 0 0
0 0 0 0 0 0 0 0 0 0 0
0 0 0 0 0 0 0 0 0 0 0
0 0 0 0 0 0 0 0 0 0 0
0 0 0 0 0 0 0 0 0 0 0
0 0 0 0 0 0 0 0 0 0 0
0 0 0 0 0 0 0 0 0 0 0
0 0 0 0 0 0 0 0 0 0 0
0 0 0 0 0 0 0 0 0 0 0
0 0 0 0 0 0 0 0 0 0 0
0 0 0 0 0 0 0 0 0 0 0
0 0 0 0 0 0 0 0 0 0 0
0 0 0 0 0 0 0 0 0 0 0
0 0 0 0 0 0 0 0 0 0 0
0 0 0 0 0 0 0 0 0 0 0
0 0 0 0 0 0 0 0 0 0 0
0 0 0 0 0 0 0 0 0 0 0
0 0 0 0 0 0 0 0 0 0 0
0 0 0 0 0 0 0 0 0 0 0
0 0 0 0 0 0 0 0 0 0 0
0 0 0 0 0 0 0 0 0 0 0
0 0 0 0 0 0 0 0 0 0 0
0 0 0 0 0 0 0 0 0 0 0
0 0 0 0 0 0 0 0 0 0 0