MODE 2
SIZE 11/70
LIMIT 0/35
COLOR LIMIT 4
STARS 2100/4500/7300
POWERUPS 1/1/0/0
17 17 0 0 0 3 0 0 0 17 17
17 17 0 0 3 3 0 0 17 17 0
0 17 17 17 3 2 3 17 17 17 0
0 0 1 1 1 2 1 1 0 0 0
0 0 1 1 1 1 2 1 1 0 0
0 0 1 1 5 5 2 1 1 0 0
0 0 3 2 5 13 5 1 1 0 0
0 3 2 5 18 18 1 1 3 0 0
0 3 2 5 5 5 5 5 2 3 0
3 2 2 2 2 1 1 2 2 3 0
17 17 17 17 17 1 1 17 17 17 17
3 2 2 2 1 1 2 2 2 3 6
6 3 2 5 1 5 5 5 2 3 6
6 3 2 5 1 1 5 2 3 6 3
3 6 3 2 5 13 5 2 3 6 3
3 6 3 2 1 1 2 3 6 3 0
0 17 17 17 1 1 1 17 17 17 0
0 3 6 3 2 2 3 6 3 0 0
0 0 3 6 3 2 3 6 3 0 0
0 0 3 6 3 3 6 3 0 0 0
0 0 0 3 17 17 17 3 0 0 0
0 0 0 17 0 0 17 0 0 0 0
0 0 0 0 0 0 0 0 0 0 0
0 0 0 0 0 0 0 0 0 0 0
0 0 0 0 0 0 0 0 0 0 0
0 0 0 0 0 0 0 0 0 0 0
0 0 0 0 0 0 0 0 0 0 0
0 0 0 0 0 0 0 0 0 0 0
0 0 0 0 0 0 0 0 0 0 0
0 0 0 0 0 0 0 0 0 0 0
0 0 0 0 0 0 0 0 0 0 0
0 0 0 0 0 0 0 0 0 0 0
0 0 0 0 0 0 0 0 0 0 0
0 0 0 0 0 0 0 0 0 0 0
0 0 0 0 0 0 0 0 0 0 0
0 0 0 0 0 0 0 0 0 0 0
0 0 0 0 0 0 0 0 0 0 0
0 0 0 0 0 0 0 0 0 0 0
0 0 0 0 0 0 0 0 0 0 0
0 0 0 0 0 0 0 0 0 0 0
0 0 0 0 0 0 0 0 0 0 0
0 0 0 0 0 0 0 0 0 0 0
0 0 0 0 0 0 0 0 0 0 0
0 0 0 0 0 0 0 0 0 0 0
0 0 0 0 0 0 0 0 0 0 0
0 0 0 0 0 0 0 0 0 0 0
0 0 0 0 0 0 0 0 0 0 0
0 0 0 0 0 0 0 0 0 0 0
0 0 0 0 0 0 0 0 0 0 0
0 0 0 0 0 0 0 0 0 0 0
0 0 0 0 0 0 0 0 0 0 0
0 0 0 0 0 0 0 0 0 0 0
0 0 0 0 0 0 0 0 0 0 0
0 0 0 0 0 0 0 0 0 0 0
0 0 0 0 0 0 0 0 0 0 0
0 0 0 0 0 0 0 0 0 0 0
0 0 0 0 0 0 0 0 0 0 0
0 0 0 0 0 0 0 0 0 0 0
0 0 0 0 0 0 0 0 0 0 0
0 0 0 0 0 0 0 0 0 0 0
0 0 0 0 0 0 0 0 0 0 0
0 0 0 0 0 0 0 0 0 0 0
0 0 0 0 0 0 0 0 0 0 0
0 0 0 0 0 0 0 0 0 0 0
0 0 0 0 0 0 0 0 0 0 0
0 0 0 0 0 0 0 0 0 0 0
0 0 0 0 0 0 0 0 0 0 0
0 0 0 0 0 0 0 0 0 0 0
0 0 0 0 0 0 0 0 0 0 0
0 0 0 0 0 0 0 0 0 0 0