MODE 2
SIZE 11/70
LIMIT 0/30
COLOR LIMIT 4
STARS 1800/3000/5300
POWERUPS 1/1/1/0
7 7 7 7 7 7 7 7 7 7 7
7 7 7 7 7 11 7 7 7 7 7
0 0 0 0 3 7 7 0 0 0 0
0 0 0 0 3 7 7 0 0 0 0
7 7 1 7 7 7 7 7 7 13 7
7 1 7 7 7 7 7 7 7 7 7
0 0 0 0 7 7 7 0 0 0 0
0 0 0 0 7 7 7 0 0 0 0
7 7 7 7 7 7 3 7 7 7 7
7 7 7 7 7 7 3 7 7 7 7
0 0 0 0 7 7 7 0 0 0 0
0 0 0 0 7 7 7 0 0 0 0
7 7 3 7 7 7 7 7 7 7 7
7 7 3 7 7 7 7 7 7 7 7
0 0 0 0 7 13 7 0 0 0 0
0 0 0 0 7 7 1 0 0 0 0
7 7 7 7 7 7 1 7 7 7 7
7 7 7 7 7 1 7 7 7 7 7
0 0 0 0 7 4 7 0 0 0 0
0 0 0 0 7 4 7 0 0 0 0
7 7 7 7 16 7 7 3 7 7 7
7 7 7 7 7 7 3 7 7 7 7
0 0 0 0 7 7 7 0 0 0 0
0 0 0 0 7 7 7 0 0 0 0
15 7 7 5 7 7 7 7 1 7 7
7 7 5 7 7 7 7 1 7 7 7
0 0 0 0 7 7 7 0 0 0 0
0 0 0 0 7 7 7 0 0 0 0
7 7 7 3 7 7 7 7 7 7 7
7 7 7 3 7 7 7 7 13 7 7
0 0 0 0 7 7 7 0 0 0 0
0 0 0 0 4 4 7 0 0 0 0
7 7 12 7 7 7 7 1 7 7 7
7 7 7 7 7 7 1 7 7 7 7
0 0 0 0 0 0 0 0 0 0 0
0 0 0 0 0 0 0 0 0 0 0
0 0 0 0 0 0 0 0 0 0 0
0 0 0 0 0 0 0 0 0 0 0
0 0 0 0 0 0 0 0 0 0 0
0 0 0 0 0 0 0 0 0 0 0
0 0 0 0 0 0 0 0 0 0 0
0 0 0 0 0 0 0 0 0 0 0
0 0 0 0 0 0 0 0 0 0 0
0 0 0 0 0 0 0 0 0 0 0
0 0 0 0 0 0 0 0 0 0 0
0 0 0 0 0 0 0 0 0 0 0
0 0 0 0 0 0 0 0 0 0 0
0 0 0 0 0 0 0 0 0 0 0
0 0 0 0 0 0 0 0 0 0 0
0 0 0 0 0 0 0 0 0 0 0
0 0 0 0 0 0 0 0 0 0 0
0 0 0 0 0 0 0 0 0 0 0
0 0 0 0 0 0 0 0 0 0 0
0 0 0 0 0 0 0 0 0 0 0
0 0 0 0 0 0 0 0 0 0 0
0 0 0 0 0 0 0 0 0 0 0
0 0 0 0 0 0 0 0 0 0 0
0 0 0 0 0 0 0 0 0 0 0
0 0 0 0 0 0 0 0 0 0 0
0 0 0 0 0 0 0 0 0 0 0
0 0 0 0 0 0 0 0 0 0 0
0 0 0 0 0 0 0 0 0 0 0
0 0 0 0 0 0 0 0 0 0 0
0 0 0 0 0 0 0 0 0 0 0
0 0 0 0 0 0 0 0 0 0 0
0 0 0 0 0 0 0 0 0 0 0
0 0 0 0 0 0 0 0 0 0 0
0 0 0 0 0 0 0 0 0 0 0
0 0 0 0 0 0 0 0 0 0 0
0 0 0 0 0 0 0 0 0 0 0