MODE 2
SIZE 11/70
LIMIT 0/35
COLOR LIMIT 4
STARS 1200/2100/4000
POWERUPS 0/0/0/0
0 0 7 17 17 17 17 17 7 0 0
0 7 7 0 0 0 7 7 3 0 0
0 5 7 0 0 0 7 0 3 7 0
7 5 0 0 0 7 0 0 7 7 0
7 7 0 0 0 7 0 0 0 7 7
7 7 7 7 18 18 7 7 7 7 0
7 7 7 7 18 13 18 7 7 7 7
7 7 7 7 18 18 7 7 7 2 0
7 7 1 3 20 20 20 3 1 2 7
7 2 3 1 20 20 1 3 7 7 0
0 2 7 1 1 12 1 1 7 7 0
0 7 7 1 3 3 1 7 7 0 0
0 7 7 1 1 10 1 1 7 7 0
7 7 3 1 20 20 1 3 7 3 0
7 7 1 3 20 20 20 3 1 3 7
7 7 7 7 18 18 7 7 7 7 0
7 7 7 7 18 11 18 7 7 7 7
7 7 7 7 18 18 7 7 7 7 0
7 7 3 3 0 0 0 3 3 7 7
7 5 3 1 0 0 1 3 7 7 0
0 5 7 1 3 0 3 1 7 7 0
0 7 7 3 3 3 3 7 7 0 0
0 7 7 3 3 15 3 3 7 7 0
7 7 1 3 20 20 3 1 7 1 0
7 7 3 1 20 0 20 1 3 1 7
7 3 3 20 0 0 20 3 3 7 0
7 3 3 20 20 20 20 20 3 3 7
7 7 7 7 7 7 7 7 7 7 0
0 0 7 7 7 7 7 7 7 0 0
0 0 0 7 7 7 7 0 0 0 0
0 0 0 0 7 7 7 0 0 0 0
0 0 0 0 0 0 0 0 0 0 0
0 0 0 0 0 0 0 0 0 0 0
0 0 0 0 0 0 0 0 0 0 0
0 0 0 0 0 0 0 0 0 0 0
0 0 0 0 0 0 0 0 0 0 0
0 0 0 0 0 0 0 0 0 0 0
0 0 0 0 0 0 0 0 0 0 0
0 0 0 0 0 0 0 0 0 0 0
0 0 0 0 0 0 0 0 0 0 0
0 0 0 0 0 0 0 0 0 0 0
0 0 0 0 0 0 0 0 0 0 0
0 0 0 0 0 0 0 0 0 0 0
0 0 0 0 0 0 0 0 0 0 0
0 0 0 0 0 0 0 0 0 0 0
0 0 0 0 0 0 0 0 0 0 0
0 0 0 0 0 0 0 0 0 0 0
0 0 0 0 0 0 0 0 0 0 0
0 0 0 0 0 0 0 0 0 0 0
0 0 0 0 0 0 0 0 0 0 0
0 0 0 0 0 0 0 0 0 0 0
0 0 0 0 0 0 0 0 0 0 0
0 0 0 0 0 0 0 0 0 0 0
0 0 0 0 0 0 0 0 0 0 0
0 0 0 0 0 0 0 0 0 0 0
0 0 0 0 0 0 0 0 0 0 0
0 0 0 0 0 0 0 0 0 0 0
0 0 0 0 0 0 0 0 0 0 0
0 0 0 0 0 0 0 0 0 0 0
0 0 0 0 0 0 0 0 0 0 0
0 0 0 0 0 0 0 0 0 0 0
0 0 0 0 0 0 0 0 0 0 0
0 0 0 0 0 0 0 0 0 0 0
0 0 0 0 0 0 0 0 0 0 0
0 0 0 0 0 0 0 0 0 0 0
0 0 0 0 0 0 0 0 0 0 0
0 0 0 0 0 0 0 0 0 0 0
0 0 0 0 0 0 0 0 0 0 0
0 0 0 0 0 0 0 0 0 0 0
0 0 0 0 0 0 0 0 0 0 0