MODE 2
SIZE 11/70
LIMIT 0/44
COLOR LIMIT 4
STARS 1200/2100/4000
POWERUPS 0/0/0/0
17 17 17 17 0 0 0 17 17 17 17
0 0 0 17 0 0 17 0 0 0 0
0 0 0 2 17 0 17 4 0 0 0
0 0 2 2 17 17 4 4 0 0 0
0 0 3 15 2 11 4 12 3 0 0
0 3 2 2 3 3 4 4 3 0 0
0 20 20 2 20 12 20 4 20 20 0
3 20 18 3 4 1 3 18 20 3 0
3 20 8 3 5 9 5 3 8 20 3
3 20 18 3 1 4 3 18 20 3 0
7 20 20 1 20 12 20 5 20 20 7
7 3 1 1 3 3 5 5 3 7 7
7 7 3 13 1 3 5 14 3 7 7
7 7 1 1 0 0 5 5 7 7 0
1 1 0 1 0 7 0 5 0 7 7
7 7 7 7 7 7 7 7 7 1 0
0 7 7 20 20 20 20 20 7 1 0
3 3 7 7 7 7 7 7 7 7 0
7 7 0 0 7 7 7 0 0 7 7
7 7 0 0 7 7 0 0 5 5 0
0 7 7 20 20 20 20 20 7 7 0
7 7 0 0 0 0 0 0 7 7 0
0 0 0 0 0 0 0 0 0 0 0
0 0 0 0 0 0 0 0 0 0 0
0 0 0 0 0 0 0 0 0 0 0
0 0 0 0 0 0 0 0 0 0 0
0 0 0 0 0 0 0 0 0 0 0
0 0 0 0 0 0 0 0 0 0 0
0 0 0 0 0 0 0 0 0 0 0
0 0 0 0 0 0 0 0 0 0 0
0 0 0 0 0 0 0 0 0 0 0
0 0 0 0 0 0 0 0 0 0 0
0 0 0 0 0 0 0 0 0 0 0
0 0 0 0 0 0 0 0 0 0 0
0 0 0 0 0 0 0 0 0 0 0
0 0 0 0 0 0 0 0 0 0 0
0 0 0 0 0 0 0 0 0 0 0
0 0 0 0 0 0 0 0 0 0 0
0 0 0 0 0 0 0 0 0 0 0
0 0 0 0 0 0 0 0 0 0 0
0 0 0 0 0 0 0 0 0 0 0
0 0 0 0 0 0 0 0 0 0 0
0 0 0 0 0 0 0 0 0 0 0
0 0 0 0 0 0 0 0 0 0 0
0 0 0 0 0 0 0 0 0 0 0
0 0 0 0 0 0 0 0 0 0 0
0 0 0 0 0 0 0 0 0 0 0
0 0 0 0 0 0 0 0 0 0 0
0 0 0 0 0 0 0 0 0 0 0
0 0 0 0 0 0 0 0 0 0 0
0 0 0 0 0 0 0 0 0 0 0
0 0 0 0 0 0 0 0 0 0 0
0 0 0 0 0 0 0 0 0 0 0
0 0 0 0 0 0 0 0 0 0 0
0 0 0 0 0 0 0 0 0 0 0
0 0 0 0 0 0 0 0 0 0 0
0 0 0 0 0 0 0 0 0 0 0
0 0 0 0 0 0 0 0 0 0 0
0 0 0 0 0 0 0 0 0 0 0
0 0 0 0 0 0 0 0 0 0 0
0 0 0 0 0 0 0 0 0 0 0
0 0 0 0 0 0 0 0 0 0 0
0 0 0 0 0 0 0 0 0 0 0
0 0 0 0 0 0 0 0 0 0 0
0 0 0 0 0 0 0 0 0 0 0
0 0 0 0 0 0 0 0 0 0 0
0 0 0 0 0 0 0 0 0 0 0
0 0 0 0 0 0 0 0 0 0 0
0 0 0 0 0 0 0 0 0 0 0
0 0 0 0 0 0 0 0 0 0 0