MODE 2
SIZE 11/70
LIMIT 0/20
COLOR LIMIT 4
STARS 2000/4200/7000
POWERUPS 0/0/0/0
7 7 7 7 7 7 7 7 7 7 7
20 0 0 7 7 7 7 0 0 0 0
0 20 1 7 7 7 7 18 18 18 18
1 13 1 7 20 7 7 0 3 3 0
0 1 1 0 7 7 7 7 3 11 3
0 0 0 0 7 7 7 7 20 3 0
18 18 18 18 18 7 12 7 20 0 0
0 0 0 0 7 7 7 7 0 0 0
0 2 2 0 7 7 7 7 0 0 0
2 16 20 20 7 20 7 3 3 3 3
0 2 2 0 7 7 7 7 3 3 3
0 0 0 0 7 7 7 7 0 0 0
1 1 1 1 1 7 20 7 7 0 0
1 1 1 1 1 7 7 7 7 18 18
0 0 0 0 0 7 7 7 7 0 0
0 0 0 0 7 7 7 7 1 1 0
0 6 6 0 7 7 7 20 20 12 1
6 11 20 20 7 7 7 0 1 1 0
0 6 6 7 7 20 7 18 18 18 18
18 18 18 7 7 7 7 0 0 0 0
0 0 0 0 7 7 7 7 1 1 13
1 1 1 1 1 1 1 1 1 1 0
0 0 0 0 0 0 0 0 0 0 0
0 0 0 0 0 0 0 0 0 0 0
0 0 0 0 0 0 0 0 0 0 0
0 0 0 0 0 0 0 0 0 0 0
0 0 0 0 0 0 0 0 0 0 0
0 0 0 0 0 0 0 0 0 0 0
0 0 0 0 0 0 0 0 0 0 0
0 0 0 0 0 0 0 0 0 0 0
0 0 0 0 0 0 0 0 0 0 0
0 0 0 0 0 0 0 0 0 0 0
0 0 0 0 0 0 0 0 0 0 0
0 0 0 0 0 0 0 0 0 0 0
0 0 0 0 0 0 0 0 0 0 0
0 0 0 0 0 0 0 0 0 0 0
0 0 0 0 0 0 0 0 0 0 0
0 0 0 0 0 0 0 0 0 0 0
0 0 0 0 0 0 0 0 0 0 0
0 0 0 0 0 0 0 0 0 0 0
0 0 0 0 0 0 0 0 0 0 0
0 0 0 0 0 0 0 0 0 0 0
0 0 0 0 0 0 0 0 0 0 0
0 0 0 0 0 0 0 0 0 0 0
0 0 0 0 0 0 0 0 0 0 0
0 0 0 0 0 0 0 0 0 0 0
0 0 0 0 0 0 0 0 0 0 0
0 0 0 0 0 0 0 0 0 0 0
0 0 0 0 0 0 0 0 0 0 0
0 0 0 0 0 0 0 0 0 0 0
0 0 0 0 0 0 0 0 0 0 0
0 0 0 0 0 0 0 0 0 0 0
0 0 0 0 0 0 0 0 0 0 0
0 0 0 0 0 0 0 0 0 0 0
0 0 0 0 0 0 0 0 0 0 0
0 0 0 0 0 0 0 0 0 0 0
0 0 0 0 0 0 0 0 0 0 0
0 0 0 0 0 0 0 0 0 0 0
0 0 0 0 0 0 0 0 0 0 0
0 0 0 0 0 0 0 0 0 0 0
0 0 0 0 0 0 0 0 0 0 0
0 0 0 0 0 0 0 0 0 0 0
0 0 0 0 0 0 0 0 0 0 0
0 0 0 0 0 0 0 0 0 0 0
0 0 0 0 0 0 0 0 0 0 0
0 0 0 0 0 0 0 0 0 0 0
0 0 0 0 0 0 0 0 0 0 0
0 0 0 0 0 0 0 0 0 0 0
0 0 0 0 0 0 0 0 0 0 0
0 0 0 0 0 0 0 0 0 0 0