MODE 2
SIZE 11/70
LIMIT 0/35
COLOR LIMIT 4
STARS 1200/2200/5300
POWERUPS 0/0/0/0
7 17 17 17 0 20 0 17 17 17 7
7 0 17 0 20 20 0 17 0 7 15
12 7 7 7 7 7 7 7 7 7 0
7 2 2 20 18 18 20 2 2 7 0
7 2 18 20 20 20 20 20 18 2 7
7 2 2 1 1 1 1 2 2 7 0
15 7 7 7 7 7 7 7 7 7 0
7 0 20 0 0 0 0 20 0 7 0
7 0 20 0 0 20 0 0 20 0 7
7 20 0 0 20 20 0 0 20 7 0
0 7 7 7 7 7 7 7 7 7 13
7 2 2 20 18 18 20 2 2 7 0
7 2 18 20 20 20 20 20 18 2 7
7 2 2 1 1 1 1 2 2 7 0
13 7 7 7 7 7 7 7 7 7 12
7 0 20 0 0 0 0 20 0 7 0
7 0 20 0 0 20 0 0 20 0 7
7 20 0 0 20 20 0 0 20 7 0
11 7 7 7 7 7 7 7 7 7 14
7 2 2 20 18 18 20 2 2 7 0
7 2 18 20 20 20 20 20 18 2 7
0 2 2 1 1 1 1 2 2 0 0
0 0 0 0 0 0 0 0 0 0 0
0 0 0 0 0 0 0 0 0 0 0
0 0 0 0 0 0 0 0 0 0 0
0 0 0 0 0 0 0 0 0 0 0
0 0 0 0 0 0 0 0 0 0 0
0 0 0 0 0 0 0 0 0 0 0
0 0 0 0 0 0 0 0 0 0 0
0 0 0 0 0 0 0 0 0 0 0
0 0 0 0 0 0 0 0 0 0 0
0 0 0 0 0 0 0 0 0 0 0
0 0 0 0 0 0 0 0 0 0 0
0 0 0 0 0 0 0 0 0 0 0
0 0 0 0 0 0 0 0 0 0 0
0 0 0 0 0 0 0 0 0 0 0
0 0 0 0 0 0 0 0 0 0 0
0 0 0 0 0 0 0 0 0 0 0
0 0 0 0 0 0 0 0 0 0 0
0 0 0 0 0 0 0 0 0 0 0
0 0 0 0 0 0 0 0 0 0 0
0 0 0 0 0 0 0 0 0 0 0
0 0 0 0 0 0 0 0 0 0 0
0 0 0 0 0 0 0 0 0 0 0
0 0 0 0 0 0 0 0 0 0 0
0 0 0 0 0 0 0 0 0 0 0
0 0 0 0 0 0 0 0 0 0 0
0 0 0 0 0 0 0 0 0 0 0
0 0 0 0 0 0 0 0 0 0 0
0 0 0 0 0 0 0 0 0 0 0
0 0 0 0 0 0 0 0 0 0 0
0 0 0 0 0 0 0 0 0 0 0
0 0 0 0 0 0 0 0 0 0 0
0 0 0 0 0 0 0 0 0 0 0
0 0 0 0 0 0 0 0 0 0 0
0 0 0 0 0 0 0 0 0 0 0
0 0 0 0 0 0 0 0 0 0 0
0 0 0 0 0 0 0 0 0 0 0
0 0 0 0 0 0 0 0 0 0 0
0 0 0 0 0 0 0 0 0 0 0
0 0 0 0 0 0 0 0 0 0 0
0 0 0 0 0 0 0 0 0 0 0
0 0 0 0 0 0 0 0 0 0 0
0 0 0 0 0 0 0 0 0 0 0
0 0 0 0 0 0 0 0 0 0 0
0 0 0 0 0 0 0 0 0 0 0
0 0 0 0 0 0 0 0 0 0 0
0 0 0 0 0 0 0 0 0 0 0
0 0 0 0 0 0 0 0 0 0 0
0 0 0 0 0 0 0 0 0 0 0