MODE 2
SIZE 11/70
LIMIT 0/30
COLOR LIMIT 4
STARS 1600/3200/4700
POWERUPS 1/1/0/0
17 17 7 7 7 7 7 7 7 17 17
0 17 7 7 18 18 7 7 17 0 0
0 0 17 7 18 13 18 7 17 0 0
0 0 17 7 18 7 7 17 0 0 0
0 0 0 17 7 7 7 17 0 0 0
0 0 17 7 7 7 7 17 0 0 0
20 20 20 17 20 20 20 17 20 20 20
20 7 7 7 20 20 7 7 7 20 0
0 20 7 7 7 11 7 7 7 20 0
0 20 7 7 20 20 7 7 20 0 0
0 0 20 7 20 7 20 7 20 0 0
7 0 20 20 7 7 20 20 0 7 7
7 7 0 20 7 15 7 20 0 7 7
7 7 7 18 7 7 18 7 7 7 0
0 7 7 7 18 18 18 7 7 7 0
14 7 7 7 7 7 7 7 7 12 0
7 7 7 7 0 0 0 7 7 7 7
7 7 7 0 0 0 0 7 7 7 7
20 20 20 20 7 7 7 20 20 20 20
0 0 20 0 7 7 0 20 0 0 0
0 0 20 0 7 7 7 0 20 0 0
0 20 7 7 7 7 7 7 20 0 0
0 0 0 0 0 0 0 0 0 0 0
0 0 0 0 0 0 0 0 0 0 0
0 0 0 0 0 0 0 0 0 0 0
0 0 0 0 0 0 0 0 0 0 0
0 0 0 0 0 0 0 0 0 0 0
0 0 0 0 0 0 0 0 0 0 0
0 0 0 0 0 0 0 0 0 0 0
0 0 0 0 0 0 0 0 0 0 0
0 0 0 0 0 0 0 0 0 0 0
0 0 0 0 0 0 0 0 0 0 0
0 0 0 0 0 0 0 0 0 0 0
0 0 0 0 0 0 0 0 0 0 0
0 0 0 0 0 0 0 0 0 0 0
0 0 0 0 0 0 0 0 0 0 0
0 0 0 0 0 0 0 0 0 0 0
0 0 0 0 0 0 0 0 0 0 0
0 0 0 0 0 0 0 0 0 0 0
0 0 0 0 0 0 0 0 0 0 0
0 0 0 0 0 0 0 0 0 0 0
0 0 0 0 0 0 0 0 0 0 0
0 0 0 0 0 0 0 0 0 0 0
0 0 0 0 0 0 0 0 0 0 0
0 0 0 0 0 0 0 0 0 0 0
0 0 0 0 0 0 0 0 0 0 0
0 0 0 0 0 0 0 0 0 0 0
0 0 0 0 0 0 0 0 0 0 0
0 0 0 0 0 0 0 0 0 0 0
0 0 0 0 0 0 0 0 0 0 0
0 0 0 0 0 0 0 0 0 0 0
0 0 0 0 0 0 0 0 0 0 0
0 0 0 0 0 0 0 0 0 0 0
0 0 0 0 0 0 0 0 0 0 0
0 0 0 0 0 0 0 0 0 0 0
0 0 0 0 0 0 0 0 0 0 0
0 0 0 0 0 0 0 0 0 0 0
0 0 0 0 0 0 0 0 0 0 0
0 0 0 0 0 0 0 0 0 0 0
0 0 0 0 0 0 0 0 0 0 0
0 0 0 0 0 0 0 0 0 0 0
0 0 0 0 0 0 0 0 0 0 0
0 0 0 0 0 0 0 0 0 0 0
0 0 0 0 0 0 0 0 0 0 0
0 0 0 0 0 0 0 0 0 0 0
0 0 0 0 0 0 0 0 0 0 0
0 0 0 0 0 0 0 0 0 0 0
0 0 0 0 0 0 0 0 0 0 0
0 0 0 0 0 0 0 0 0 0 0
0 0 0 0 0 0 0 0 0 0 0