MODE 2
SIZE 11/70
LIMIT 0/70
COLOR LIMIT 4
STARS 4500/8500/11600
POWERUPS 1/1/0/0
7 0 0 0 0 0 0 0 0 20 7
7 3 0 0 0 0 0 0 20 7 20
3 11 3 0 0 0 0 0 20 7 20
3 3 7 0 0 0 0 3 3 20 0
0 7 7 7 0 0 0 3 11 3 0
0 7 7 7 0 0 7 7 3 0 0
0 0 7 7 7 0 7 7 7 0 0
0 0 7 7 7 7 7 7 0 0 0
0 0 0 7 5 5 7 7 0 0 0
0 0 0 5 7 5 7 0 0 0 0
18 18 18 18 5 7 20 18 18 18 18
0 0 0 20 7 7 20 0 0 0 0
0 0 0 20 7 20 7 20 0 0 0
0 0 20 7 20 20 7 20 0 0 0
0 0 20 7 20 0 20 3 3 0 0
0 1 1 20 0 0 3 12 3 0 0
0 1 13 1 0 0 0 3 7 7 0
7 1 7 0 0 0 0 7 7 7 0
7 7 7 0 0 0 0 0 7 7 7
7 7 0 0 0 0 0 0 7 7 7
7 7 18 18 18 18 18 18 18 5 5
7 7 0 0 0 0 0 0 5 13 5
7 7 7 0 0 0 0 0 0 5 7
7 7 7 0 0 0 0 0 7 7 7
0 7 3 3 0 0 0 0 7 7 7
0 3 12 3 0 0 0 20 3 3 0
0 0 3 7 20 0 0 20 7 15 3
0 0 20 7 20 0 20 7 3 3 0
0 0 0 20 7 20 20 7 20 0 0
0 0 0 20 7 2 2 20 0 0 0
0 0 0 0 20 7 13 2 0 0 0
18 18 18 18 20 7 2 18 18 18 18
0 0 0 0 20 7 7 20 0 0 0
0 0 0 20 7 20 7 20 0 0 0
0 0 0 3 3 20 20 7 20 0 0
0 0 3 15 3 0 20 7 20 0 0
0 0 7 3 3 0 0 20 7 20 0
0 7 7 7 0 0 0 20 7 20 0
0 7 7 7 0 0 0 0 20 7 20
1 1 7 0 0 0 0 0 20 7 20
1 12 1 0 0 0 0 0 0 3 3
1 18 18 18 18 18 18 18 3 15 3
7 20 0 0 0 0 0 0 0 3 7
7 20 0 0 0 0 0 0 7 7 7
20 7 20 0 0 0 0 0 7 7 7
20 7 20 0 0 0 0 1 7 7 0
0 20 3 3 0 0 0 1 7 1 0
0 3 14 3 0 0 20 1 1 0 0
0 0 3 7 7 0 20 7 20 0 0
0 0 7 7 7 20 7 20 0 0 0
0 0 0 7 7 7 7 20 0 0 0
0 0 0 7 5 5 20 0 0 0 0
18 18 18 18 5 7 5 18 18 18 18
0 0 0 20 7 7 20 0 0 0 0
0 0 0 20 7 20 7 20 0 0 0
0 0 20 7 20 20 7 20 0 0 0
0 0 20 7 20 0 20 7 20 0 0
0 20 7 20 0 0 20 3 3 0 0
0 1 1 20 0 0 0 3 15 3 0
1 14 1 0 0 0 0 7 3 7 0
20 1 20 0 0 0 0 0 7 7 7
20 20 18 18 18 18 18 18 7 7 7
7 20 0 0 0 0 0 0 0 7 7
20 0 0 0 0 0 0 0 0 7 7
0 0 0 0 0 0 0 0 0 0 0
0 0 0 0 0 0 0 0 0 0 0
0 0 0 0 0 0 0 0 0 0 0
0 0 0 0 0 0 0 0 0 0 0
0 0 0 0 0 0 0 0 0 0 0
0 0 0 0 0 0 0 0 0 0 0