MODE 2
SIZE 11/70
LIMIT 0/30
COLOR LIMIT 4
STARS 1300/3600/6000
POWERUPS 1/0/0/0
7 7 0 0 0 0 3 3 0 0 0
7 7 20 20 20 3 11 3 0 0 0
7 7 0 1 1 20 3 3 0 7 7
0 0 1 17 1 20 20 20 7 7 0
7 7 0 1 1 18 2 2 0 7 7
7 7 20 20 20 2 17 2 0 0 0
7 7 0 5 5 20 2 2 0 7 7
0 0 5 12 5 20 20 20 7 7 0
7 7 0 5 5 18 4 4 0 7 7
7 7 20 20 20 4 17 4 0 0 0
7 7 0 3 3 20 4 4 0 7 7
0 0 3 16 3 20 20 20 7 7 0
7 7 0 3 3 18 6 6 0 7 7
7 7 20 20 20 6 13 6 0 0 0
7 7 0 2 2 20 6 6 0 7 7
0 0 2 17 2 20 20 20 7 7 0
7 7 0 2 2 18 1 1 0 7 7
7 7 20 20 20 1 17 1 0 0 0
7 7 0 5 5 20 1 1 0 7 7
0 0 5 14 5 20 20 20 7 7 0
7 7 0 5 5 18 2 2 0 7 7
7 7 20 20 20 2 15 2 0 0 0
7 7 0 1 1 20 2 2 0 7 7
0 0 1 17 1 20 20 20 7 7 0
0 0 0 1 1 0 0 0 0 7 7
0 0 0 0 0 0 0 0 0 0 0
0 0 0 0 0 0 0 0 0 0 0
0 0 0 0 0 0 0 0 0 0 0
0 0 0 0 0 0 0 0 0 0 0
0 0 0 0 0 0 0 0 0 0 0
0 0 0 0 0 0 0 0 0 0 0
0 0 0 0 0 0 0 0 0 0 0
0 0 0 0 0 0 0 0 0 0 0
0 0 0 0 0 0 0 0 0 0 0
0 0 0 0 0 0 0 0 0 0 0
0 0 0 0 0 0 0 0 0 0 0
0 0 0 0 0 0 0 0 0 0 0
0 0 0 0 0 0 0 0 0 0 0
0 0 0 0 0 0 0 0 0 0 0
0 0 0 0 0 0 0 0 0 0 0
0 0 0 0 0 0 0 0 0 0 0
0 0 0 0 0 0 0 0 0 0 0
0 0 0 0 0 0 0 0 0 0 0
0 0 0 0 0 0 0 0 0 0 0
0 0 0 0 0 0 0 0 0 0 0
0 0 0 0 0 0 0 0 0 0 0
0 0 0 0 0 0 0 0 0 0 0
0 0 0 0 0 0 0 0 0 0 0
0 0 0 0 0 0 0 0 0 0 0
0 0 0 0 0 0 0 0 0 0 0
0 0 0 0 0 0 0 0 0 0 0
0 0 0 0 0 0 0 0 0 0 0
0 0 0 0 0 0 0 0 0 0 0
0 0 0 0 0 0 0 0 0 0 0
0 0 0 0 0 0 0 0 0 0 0
0 0 0 0 0 0 0 0 0 0 0
0 0 0 0 0 0 0 0 0 0 0
0 0 0 0 0 0 0 0 0 0 0
0 0 0 0 0 0 0 0 0 0 0
0 0 0 0 0 0 0 0 0 0 0
0 0 0 0 0 0 0 0 0 0 0
0 0 0 0 0 0 0 0 0 0 0
0 0 0 0 0 0 0 0 0 0 0
0 0 0 0 0 0 0 0 0 0 0
0 0 0 0 0 0 0 0 0 0 0
0 0 0 0 0 0 0 0 0 0 0
0 0 0 0 0 0 0 0 0 0 0
0 0 0 0 0 0 0 0 0 0 0
0 0 0 0 0 0 0 0 0 0 0
0 0 0 0 0 0 0 0 0 0 0