MODE 2
SIZE 11/70
LIMIT 0/35
COLOR LIMIT 4
STARS 1300/3600/6000
POWERUPS 0/0/0/0
17 17 5 5 5 4 5 5 5 17 17
0 1 5 5 4 4 5 5 1 0 0
0 1 17 5 4 15 4 5 17 1 0
1 5 3 4 18 18 4 3 5 1 0
1 0 5 3 4 11 4 3 5 0 1
17 17 5 17 4 4 17 5 17 17 0
5 5 5 18 17 4 17 18 5 5 5
2 2 2 18 3 3 18 2 2 2 2
3 3 11 2 3 17 3 2 13 3 3
2 2 2 20 3 3 20 2 2 2 2
20 20 20 20 3 20 3 20 20 20 20
5 5 5 17 2 5 17 5 5 5 0
1 1 5 17 20 5 20 17 5 1 1
5 5 3 20 5 2 20 3 5 5 0
17 17 3 20 5 18 2 20 3 17 17
0 0 20 5 18 18 2 20 0 0 0
0 0 20 6 18 11 18 6 20 0 0
0 0 20 6 18 18 6 20 0 0 0
0 0 0 20 6 12 6 20 0 0 0
0 0 0 20 20 20 20 0 0 0 0
0 0 0 0 0 0 0 0 0 0 0
0 0 0 0 0 0 0 0 0 0 0
0 0 0 0 0 0 0 0 0 0 0
0 0 0 0 0 0 0 0 0 0 0
0 0 0 0 0 0 0 0 0 0 0
0 0 0 0 0 0 0 0 0 0 0
0 0 0 0 0 0 0 0 0 0 0
0 0 0 0 0 0 0 0 0 0 0
0 0 0 0 0 0 0 0 0 0 0
0 0 0 0 0 0 0 0 0 0 0
0 0 0 0 0 0 0 0 0 0 0
0 0 0 0 0 0 0 0 0 0 0
0 0 0 0 0 0 0 0 0 0 0
0 0 0 0 0 0 0 0 0 0 0
0 0 0 0 0 0 0 0 0 0 0
0 0 0 0 0 0 0 0 0 0 0
0 0 0 0 0 0 0 0 0 0 0
0 0 0 0 0 0 0 0 0 0 0
0 0 0 0 0 0 0 0 0 0 0
0 0 0 0 0 0 0 0 0 0 0
0 0 0 0 0 0 0 0 0 0 0
0 0 0 0 0 0 0 0 0 0 0
0 0 0 0 0 0 0 0 0 0 0
0 0 0 0 0 0 0 0 0 0 0
0 0 0 0 0 0 0 0 0 0 0
0 0 0 0 0 0 0 0 0 0 0
0 0 0 0 0 0 0 0 0 0 0
0 0 0 0 0 0 0 0 0 0 0
0 0 0 0 0 0 0 0 0 0 0
0 0 0 0 0 0 0 0 0 0 0
0 0 0 0 0 0 0 0 0 0 0
0 0 0 0 0 0 0 0 0 0 0
0 0 0 0 0 0 0 0 0 0 0
0 0 0 0 0 0 0 0 0 0 0
0 0 0 0 0 0 0 0 0 0 0
0 0 0 0 0 0 0 0 0 0 0
0 0 0 0 0 0 0 0 0 0 0
0 0 0 0 0 0 0 0 0 0 0
0 0 0 0 0 0 0 0 0 0 0
0 0 0 0 0 0 0 0 0 0 0
0 0 0 0 0 0 0 0 0 0 0
0 0 0 0 0 0 0 0 0 0 0
0 0 0 0 0 0 0 0 0 0 0
0 0 0 0 0 0 0 0 0 0 0
0 0 0 0 0 0 0 0 0 0 0
0 0 0 0 0 0 0 0 0 0 0
0 0 0 0 0 0 0 0 0 0 0
0 0 0 0 0 0 0 0 0 0 0
0 0 0 0 0 0 0 0 0 0 0
0 0 0 0 0 0 0 0 0 0 0