MODE 2
SIZE 11/70
LIMIT 0/53
COLOR LIMIT 4
STARS 3600/7900/11400
POWERUPS 1/0/0/0
17 17 17 17 2 20 2 17 17 17 17
17 2 2 2 20 20 2 2 2 17 0
0 17 11 3 5 20 5 3 14 17 0
0 17 5 5 4 4 5 5 17 0 0
0 1 17 1 4 12 4 1 17 1 0
1 3 17 1 4 4 1 17 3 1 0
1 3 17 3 1 3 1 3 17 3 1
1 20 3 1 3 3 1 3 20 1 0
20 20 1 1 3 7 3 1 1 20 20
20 3 3 3 7 7 3 3 3 20 0
0 20 20 20 7 18 7 20 20 20 0
7 7 7 7 18 18 7 7 7 7 0
0 7 7 0 18 13 18 0 7 7 0
7 7 7 7 18 18 7 7 7 7 0
0 20 20 20 7 18 7 20 20 20 0
20 0 0 0 7 7 0 0 0 20 0
20 20 1 1 0 7 0 1 1 20 20
1 20 3 1 0 0 1 3 20 1 0
1 3 0 3 1 0 1 3 0 3 1
1 3 3 1 0 0 1 3 3 1 0
0 1 1 1 4 4 4 1 1 1 0
2 2 5 4 15 18 4 5 2 2 2
19 19 2 5 4 4 4 5 2 19 19
2 2 2 5 3 3 5 2 2 2 2
1 1 1 1 1 3 1 1 1 1 1
3 3 3 3 5 5 3 3 3 3 0
1 1 1 1 1 5 1 1 1 1 1
0 0 0 0 0 0 0 0 0 0 0
0 0 0 0 0 0 0 0 0 0 0
0 0 0 0 0 0 0 0 0 0 0
0 0 0 0 0 0 0 0 0 0 0
0 0 0 0 0 0 0 0 0 0 0
0 0 0 0 0 0 0 0 0 0 0
0 0 0 0 0 0 0 0 0 0 0
0 0 0 0 0 0 0 0 0 0 0
0 0 0 0 0 0 0 0 0 0 0
0 0 0 0 0 0 0 0 0 0 0
0 0 0 0 0 0 0 0 0 0 0
0 0 0 0 0 0 0 0 0 0 0
0 0 0 0 0 0 0 0 0 0 0
0 0 0 0 0 0 0 0 0 0 0
0 0 0 0 0 0 0 0 0 0 0
0 0 0 0 0 0 0 0 0 0 0
0 0 0 0 0 0 0 0 0 0 0
0 0 0 0 0 0 0 0 0 0 0
0 0 0 0 0 0 0 0 0 0 0
0 0 0 0 0 0 0 0 0 0 0
0 0 0 0 0 0 0 0 0 0 0
0 0 0 0 0 0 0 0 0 0 0
0 0 0 0 0 0 0 0 0 0 0
0 0 0 0 0 0 0 0 0 0 0
0 0 0 0 0 0 0 0 0 0 0
0 0 0 0 0 0 0 0 0 0 0
0 0 0 0 0 0 0 0 0 0 0
0 0 0 0 0 0 0 0 0 0 0
0 0 0 0 0 0 0 0 0 0 0
0 0 0 0 0 0 0 0 0 0 0
0 0 0 0 0 0 0 0 0 0 0
0 0 0 0 0 0 0 0 0 0 0
0 0 0 0 0 0 0 0 0 0 0
0 0 0 0 0 0 0 0 0 0 0
0 0 0 0 0 0 0 0 0 0 0
0 0 0 0 0 0 0 0 0 0 0
0 0 0 0 0 0 0 0 0 0 0
0 0 0 0 0 0 0 0 0 0 0
0 0 0 0 0 0 0 0 0 0 0
0 0 0 0 0 0 0 0 0 0 0
0 0 0 0 0 0 0 0 0 0 0
0 0 0 0 0 0 0 0 0 0 0
0 0 0 0 0 0 0 0 0 0 0