MODE 2
SIZE 11/70
LIMIT 0/45
COLOR LIMIT 4
STARS 6000/10000/15000
POWERUPS 0/0/0/0
18 18 18 18 18 18 18 18 18 18 18
18 1 1 1 1 1 1 1 1 18 0
0 18 1 3 3 1 1 1 1 18 0
18 1 3 11 3 1 1 1 1 18 0
18 5 5 18 3 5 5 2 2 5 18
5 5 18 5 5 5 2 13 2 5 5
5 5 5 1 1 5 5 18 2 5 5
20 20 1 18 1 20 18 20 3 3 20
2 2 2 18 1 2 2 2 3 11 3
2 2 18 2 2 2 2 2 18 3 2
20 20 20 20 20 20 20 20 18 20 20
3 3 2 2 3 3 3 3 3 5 5
3 3 2 15 2 3 3 3 3 5 12
3 3 18 2 3 3 3 3 3 18 5
20 20 18 20 20 1 1 20 20 18 20
2 2 2 2 1 13 1 2 2 2 2
2 2 2 2 2 18 1 2 2 2 2
20 20 20 20 18 20 20 20 5 5 20
3 1 1 3 3 3 3 3 5 18 5
1 15 1 3 3 3 3 3 18 5 3
3 18 1 3 3 3 3 3 18 20 20
18 20 20 20 20 20 20 20 20 3 3
4 4 4 4 3 3 4 4 4 3 18
4 4 4 3 12 3 4 4 4 18 3
4 4 4 4 18 3 4 4 4 18 4
5 5 1 18 1 1 1 1 1 1 1
5 11 5 1 1 1 1 1 1 1 1
18 5 1 1 1 1 1 1 1 1 1
18 20 20 20 20 20 20 20 20 20 20
0 0 0 0 0 0 0 0 0 0 0
0 0 0 0 0 0 0 0 0 0 0
0 0 0 0 0 0 0 0 0 0 0
0 0 0 0 0 0 0 0 0 0 0
0 0 0 0 0 0 0 0 0 0 0
0 0 0 0 0 0 0 0 0 0 0
0 0 0 0 0 0 0 0 0 0 0
0 0 0 0 0 0 0 0 0 0 0
0 0 0 0 0 0 0 0 0 0 0
0 0 0 0 0 0 0 0 0 0 0
0 0 0 0 0 0 0 0 0 0 0
0 0 0 0 0 0 0 0 0 0 0
0 0 0 0 0 0 0 0 0 0 0
0 0 0 0 0 0 0 0 0 0 0
0 0 0 0 0 0 0 0 0 0 0
0 0 0 0 0 0 0 0 0 0 0
0 0 0 0 0 0 0 0 0 0 0
0 0 0 0 0 0 0 0 0 0 0
0 0 0 0 0 0 0 0 0 0 0
0 0 0 0 0 0 0 0 0 0 0
0 0 0 0 0 0 0 0 0 0 0
0 0 0 0 0 0 0 0 0 0 0
0 0 0 0 0 0 0 0 0 0 0
0 0 0 0 0 0 0 0 0 0 0
0 0 0 0 0 0 0 0 0 0 0
0 0 0 0 0 0 0 0 0 0 0
0 0 0 0 0 0 0 0 0 0 0
0 0 0 0 0 0 0 0 0 0 0
0 0 0 0 0 0 0 0 0 0 0
0 0 0 0 0 0 0 0 0 0 0
0 0 0 0 0 0 0 0 0 0 0
0 0 0 0 0 0 0 0 0 0 0
0 0 0 0 0 0 0 0 0 0 0
0 0 0 0 0 0 0 0 0 0 0
0 0 0 0 0 0 0 0 0 0 0
0 0 0 0 0 0 0 0 0 0 0
0 0 0 0 0 0 0 0 0 0 0
0 0 0 0 0 0 0 0 0 0 0
0 0 0 0 0 0 0 0 0 0 0
0 0 0 0 0 0 0 0 0 0 0
0 0 0 0 0 0 0 0 0 0 0