MODE 2
SIZE 11/70
LIMIT 0/25
COLOR LIMIT 4
STARS 1300/3000/5650
POWERUPS 0/0/0/0
17 0 0 0 0 0 0 0 0 0 17
17 0 0 0 0 0 0 0 0 17 0
0 17 0 0 0 0 0 0 0 17 0
0 17 0 0 0 0 0 0 17 0 0
0 0 17 1 1 5 1 1 17 0 0
0 0 17 20 5 5 20 17 0 0 0
0 0 1 20 5 11 5 20 1 0 0
0 1 20 5 5 5 5 20 1 0 0
0 0 1 20 20 20 20 20 1 0 0
0 0 1 3 3 3 3 1 0 0 0
0 0 0 3 1 20 1 1 3 0 0
0 0 3 20 20 20 20 20 3 0 0
0 0 3 20 5 13 18 5 20 3 0
0 0 3 20 20 20 20 20 3 0 0
0 0 0 2 2 20 2 2 3 0 0
0 0 2 3 3 3 3 3 0 0 0
0 0 2 20 20 20 20 20 2 0 0
0 2 20 5 5 5 5 20 2 0 0
0 0 2 20 5 12 5 20 2 0 0
0 0 2 17 5 5 17 2 0 0 0
0 0 0 17 2 5 2 17 0 0 0
0 0 17 0 0 0 0 17 0 0 0
17 17 17 7 7 15 7 7 17 17 17
7 7 7 7 7 7 7 7 7 7 7
7 7 7 7 7 7 7 7 7 7 7
7 0 0 0 7 7 7 0 0 0 7
7 7 7 7 7 7 7 7 7 7 7
0 0 0 0 0 0 0 0 0 0 0
0 0 0 0 0 0 0 0 0 0 0
0 0 0 0 0 0 0 0 0 0 0
0 0 0 0 0 0 0 0 0 0 0
0 0 0 0 0 0 0 0 0 0 0
0 0 0 0 0 0 0 0 0 0 0
0 0 0 0 0 0 0 0 0 0 0
0 0 0 0 0 0 0 0 0 0 0
0 0 0 0 0 0 0 0 0 0 0
0 0 0 0 0 0 0 0 0 0 0
0 0 0 0 0 0 0 0 0 0 0
0 0 0 0 0 0 0 0 0 0 0
0 0 0 0 0 0 0 0 0 0 0
0 0 0 0 0 0 0 0 0 0 0
0 0 0 0 0 0 0 0 0 0 0
0 0 0 0 0 0 0 0 0 0 0
0 0 0 0 0 0 0 0 0 0 0
0 0 0 0 0 0 0 0 0 0 0
0 0 0 0 0 0 0 0 0 0 0
0 0 0 0 0 0 0 0 0 0 0
0 0 0 0 0 0 0 0 0 0 0
0 0 0 0 0 0 0 0 0 0 0
0 0 0 0 0 0 0 0 0 0 0
0 0 0 0 0 0 0 0 0 0 0
0 0 0 0 0 0 0 0 0 0 0
0 0 0 0 0 0 0 0 0 0 0
0 0 0 0 0 0 0 0 0 0 0
0 0 0 0 0 0 0 0 0 0 0
0 0 0 0 0 0 0 0 0 0 0
0 0 0 0 0 0 0 0 0 0 0
0 0 0 0 0 0 0 0 0 0 0
0 0 0 0 0 0 0 0 0 0 0
0 0 0 0 0 0 0 0 0 0 0
0 0 0 0 0 0 0 0 0 0 0
0 0 0 0 0 0 0 0 0 0 0
0 0 0 0 0 0 0 0 0 0 0
0 0 0 0 0 0 0 0 0 0 0
0 0 0 0 0 0 0 0 0 0 0
0 0 0 0 0 0 0 0 0 0 0
0 0 0 0 0 0 0 0 0 0 0
0 0 0 0 0 0 0 0 0 0 0
0 0 0 0 0 0 0 0 0 0 0
0 0 0 0 0 0 0 0 0 0 0