MODE 2
SIZE 11/70
LIMIT 0/35
COLOR LIMIT 4
STARS 1600/3900/7000
POWERUPS 1/1/1/0
0 20 7 7 7 0 7 7 7 20 0
20 7 18 18 7 7 18 18 7 20 0
17 17 7 7 7 13 7 7 7 17 17
20 0 0 7 0 0 7 0 0 20 0
20 7 7 7 7 7 7 7 7 7 20
20 0 7 18 0 0 18 7 0 20 0
17 17 7 7 7 11 7 7 7 17 17
20 0 0 7 0 0 7 0 0 20 0
20 7 7 7 7 7 7 7 7 7 20
20 0 7 18 0 0 18 7 0 20 0
17 17 7 7 7 8 7 7 7 17 17
20 0 0 7 0 0 7 0 0 20 0
20 7 7 7 7 7 7 7 7 7 20
20 0 7 18 0 0 18 7 0 20 0
17 17 7 7 7 12 7 7 7 17 17
20 0 0 7 0 0 7 0 0 20 0
20 7 7 7 7 7 7 7 7 7 20
20 0 7 18 0 0 18 7 0 20 0
17 17 7 7 7 14 7 7 7 17 17
20 0 0 7 0 0 7 0 0 20 0
20 7 7 7 7 7 7 7 7 7 20
20 0 7 18 0 0 18 7 0 20 0
17 17 7 7 7 8 7 7 7 17 17
20 0 0 7 0 0 7 0 0 20 0
20 7 7 7 7 7 7 7 7 7 20
20 0 7 18 0 0 18 7 0 20 0
17 17 7 7 7 15 7 7 7 17 17
0 0 0 7 0 0 7 0 0 0 0
0 7 7 7 7 7 7 7 7 7 0
0 0 7 18 0 0 18 7 0 0 0
7 7 7 7 7 7 7 7 7 7 7
0 0 0 0 0 0 0 0 0 0 0
0 0 0 0 0 0 0 0 0 0 0
0 0 0 0 0 0 0 0 0 0 0
0 0 0 0 0 0 0 0 0 0 0
0 0 0 0 0 0 0 0 0 0 0
0 0 0 0 0 0 0 0 0 0 0
0 0 0 0 0 0 0 0 0 0 0
0 0 0 0 0 0 0 0 0 0 0
0 0 0 0 0 0 0 0 0 0 0
0 0 0 0 0 0 0 0 0 0 0
0 0 0 0 0 0 0 0 0 0 0
0 0 0 0 0 0 0 0 0 0 0
0 0 0 0 0 0 0 0 0 0 0
0 0 0 0 0 0 0 0 0 0 0
0 0 0 0 0 0 0 0 0 0 0
0 0 0 0 0 0 0 0 0 0 0
0 0 0 0 0 0 0 0 0 0 0
0 0 0 0 0 0 0 0 0 0 0
0 0 0 0 0 0 0 0 0 0 0
0 0 0 0 0 0 0 0 0 0 0
0 0 0 0 0 0 0 0 0 0 0
0 0 0 0 0 0 0 0 0 0 0
0 0 0 0 0 0 0 0 0 0 0
0 0 0 0 0 0 0 0 0 0 0
0 0 0 0 0 0 0 0 0 0 0
0 0 0 0 0 0 0 0 0 0 0
0 0 0 0 0 0 0 0 0 0 0
0 0 0 0 0 0 0 0 0 0 0
0 0 0 0 0 0 0 0 0 0 0
0 0 0 0 0 0 0 0 0 0 0
0 0 0 0 0 0 0 0 0 0 0
0 0 0 0 0 0 0 0 0 0 0
0 0 0 0 0 0 0 0 0 0 0
0 0 0 0 0 0 0 0 0 0 0
0 0 0 0 0 0 0 0 0 0 0
0 0 0 0 0 0 0 0 0 0 0
0 0 0 0 0 0 0 0 0 0 0
0 0 0 0 0 0 0 0 0 0 0
0 0 0 0 0 0 0 0 0 0 0