MODE 2
SIZE 11/70
LIMIT 0/50
COLOR LIMIT 4
STARS 3200/7500/11500
POWERUPS 1/0/0/0
7 7 7 0 7 7 7 0 7 7 7
7 7 0 0 7 7 0 0 7 7 0
7 11 7 20 7 7 7 20 1 1 1
7 7 0 0 7 7 0 0 7 7 0
3 3 3 0 7 7 7 0 7 7 7
7 7 0 0 2 2 0 0 7 7 0
7 7 7 20 7 7 7 20 7 11 7
7 7 0 0 7 7 0 0 7 7 0
7 12 7 0 7 7 7 0 7 7 7
7 7 0 0 7 7 0 0 7 7 0
7 7 7 20 7 7 7 20 7 7 7
5 5 0 0 7 7 0 0 7 7 0
7 7 7 0 7 7 7 0 3 3 3
7 7 0 0 7 7 0 0 7 7 0
7 7 7 20 7 13 7 20 7 7 7
7 7 0 0 7 7 0 0 7 7 0
1 1 1 0 7 7 7 0 7 14 7
7 7 0 0 2 2 0 0 7 7 0
7 7 7 20 7 7 7 20 7 7 7
7 7 0 0 7 7 0 0 7 7 0
7 7 7 0 7 7 7 0 7 7 7
7 7 0 0 7 7 0 0 5 5 0
3 3 3 20 7 7 7 20 7 7 7
7 7 0 0 7 7 0 0 7 7 0
7 7 7 0 7 7 4 0 7 7 7
7 7 0 0 7 4 0 0 7 7 0
7 13 7 20 7 4 7 20 1 1 1
7 7 0 0 4 7 0 0 7 7 0
7 7 7 0 4 7 7 0 7 7 7
5 5 0 0 7 7 0 0 7 7 0
7 7 7 20 7 7 7 20 7 7 7
7 7 0 0 7 7 0 0 7 7 0
7 7 7 0 7 7 7 0 3 3 3
7 7 0 0 7 7 0 0 7 7 0
7 7 7 20 7 14 7 20 7 7 7
7 7 0 0 7 7 0 0 7 7 0
1 1 1 0 7 7 7 0 7 12 7
7 7 0 0 7 7 0 0 7 7 0
7 15 7 20 7 7 7 20 7 7 7
7 7 0 0 7 7 0 0 5 5 0
7 7 7 0 7 7 7 0 7 7 7
7 7 0 0 7 7 0 0 7 7 0
3 3 3 20 4 4 4 20 7 7 7
7 7 0 0 7 7 0 0 7 7 0
7 7 7 0 7 7 7 0 7 15 7
0 0 0 0 0 0 0 0 0 0 0
0 0 0 0 0 0 0 0 0 0 0
0 0 0 0 0 0 0 0 0 0 0
0 0 0 0 0 0 0 0 0 0 0
0 0 0 0 0 0 0 0 0 0 0
0 0 0 0 0 0 0 0 0 0 0
0 0 0 0 0 0 0 0 0 0 0
0 0 0 0 0 0 0 0 0 0 0
0 0 0 0 0 0 0 0 0 0 0
0 0 0 0 0 0 0 0 0 0 0
0 0 0 0 0 0 0 0 0 0 0
0 0 0 0 0 0 0 0 0 0 0
0 0 0 0 0 0 0 0 0 0 0
0 0 0 0 0 0 0 0 0 0 0
0 0 0 0 0 0 0 0 0 0 0
0 0 0 0 0 0 0 0 0 0 0
0 0 0 0 0 0 0 0 0 0 0
0 0 0 0 0 0 0 0 0 0 0
0 0 0 0 0 0 0 0 0 0 0
0 0 0 0 0 0 0 0 0 0 0
0 0 0 0 0 0 0 0 0 0 0
0 0 0 0 0 0 0 0 0 0 0
0 0 0 0 0 0 0 0 0 0 0
0 0 0 0 0 0 0 0 0 0 0
0 0 0 0 0 0 0 0 0 0 0