MODE 2
SIZE 11/70
LIMIT 0/65
COLOR LIMIT 4
STARS 3200/7500/11500
POWERUPS 1/1/1/1
7 7 7 7 7 7 7 7 7 7 7
7 20 20 20 20 7 7 20 7 7 7
7 7 20 11 20 7 8 20 20 7 7
7 7 20 20 7 7 20 12 20 7 7
7 7 7 20 7 7 20 20 20 20 7
10 17 7 7 7 7 7 7 7 7 7
17 7 7 7 20 7 7 18 18 18 18
17 17 7 20 20 7 7 18 7 7 7
7 7 7 20 13 20 7 7 18 18 18
7 7 20 20 20 20 7 7 7 7 7
7 7 7 7 7 7 7 7 7 7 7
7 20 20 20 20 7 7 7 20 7 7
7 7 20 14 20 7 7 7 20 20 7
7 7 20 20 7 7 7 7 8 20 7
7 7 7 20 7 7 7 20 20 20 20
7 7 7 7 7 7 7 7 7 7 7
7 7 20 7 7 20 20 7 7 7 7
7 20 20 7 20 8 20 7 20 7 7
7 20 8 7 7 7 20 7 20 20 7
20 20 20 20 7 7 7 20 15 20 7
18 18 18 18 7 7 7 20 20 20 20
7 7 18 7 7 7 7 7 7 7 7
18 18 18 7 7 7 7 7 7 17 10
7 7 7 7 7 7 7 7 7 7 17
7 7 7 7 20 20 20 20 7 17 17
7 7 7 7 20 16 20 7 7 7 7
7 7 7 7 7 20 20 7 7 7 7
7 7 7 7 7 20 7 7 7 7 7
7 7 7 7 7 7 7 7 7 7 7
7 7 7 7 7 7 7 7 7 7 7
0 0 0 0 0 0 0 0 0 0 0
0 0 0 0 0 0 0 0 0 0 0
0 0 0 0 0 0 0 0 0 0 0
0 0 0 0 0 0 0 0 0 0 0
0 0 0 0 0 0 0 0 0 0 0
0 0 0 0 0 0 0 0 0 0 0
0 0 0 0 0 0 0 0 0 0 0
0 0 0 0 0 0 0 0 0 0 0
0 0 0 0 0 0 0 0 0 0 0
0 0 0 0 0 0 0 0 0 0 0
0 0 0 0 0 0 0 0 0 0 0
0 0 0 0 0 0 0 0 0 0 0
0 0 0 0 0 0 0 0 0 0 0
0 0 0 0 0 0 0 0 0 0 0
0 0 0 0 0 0 0 0 0 0 0
0 0 0 0 0 0 0 0 0 0 0
0 0 0 0 0 0 0 0 0 0 0
0 0 0 0 0 0 0 0 0 0 0
0 0 0 0 0 0 0 0 0 0 0
0 0 0 0 0 0 0 0 0 0 0
0 0 0 0 0 0 0 0 0 0 0
0 0 0 0 0 0 0 0 0 0 0
0 0 0 0 0 0 0 0 0 0 0
0 0 0 0 0 0 0 0 0 0 0
0 0 0 0 0 0 0 0 0 0 0
0 0 0 0 0 0 0 0 0 0 0
0 0 0 0 0 0 0 0 0 0 0
0 0 0 0 0 0 0 0 0 0 0
0 0 0 0 0 0 0 0 0 0 0
0 0 0 0 0 0 0 0 0 0 0
0 0 0 0 0 0 0 0 0 0 0
0 0 0 0 0 0 0 0 0 0 0
0 0 0 0 0 0 0 0 0 0 0
0 0 0 0 0 0 0 0 0 0 0
0 0 0 0 0 0 0 0 0 0 0
0 0 0 0 0 0 0 0 0 0 0
0 0 0 0 0 0 0 0 0 0 0
0 0 0 0 0 0 0 0 0 0 0
0 0 0 0 0 0 0 0 0 0 0
0 0 0 0 0 0 0 0 0 0 0