MODE 2
SIZE 11/70
LIMIT 0/38
COLOR LIMIT 4
STARS 1000/2850/5000
POWERUPS 0/0/0/0
0 0 0 0 0 0 0 0 0 0 17
0 0 0 0 0 0 0 0 0 17 0
0 0 0 0 0 0 0 0 0 17 0
0 0 0 0 0 0 0 0 17 0 0
0 0 0 0 0 3 0 0 17 0 0
0 0 0 0 3 3 0 17 0 0 0
0 0 0 0 3 12 3 17 0 0 0
0 1 1 3 1 1 17 1 1 1 0
0 0 1 3 2 17 17 3 14 1 0
0 0 3 2 18 13 2 3 1 0 0
0 0 3 1 2 18 18 2 1 0 0
0 3 15 1 2 2 2 1 3 0 0
0 3 3 3 1 3 3 3 3 3 0
0 0 0 0 20 16 20 0 0 0 0
20 20 7 20 20 1 1 20 7 20 20
20 7 20 20 7 1 20 7 20 20 7
20 7 20 20 7 20 20 7 20 20 7
7 18 18 7 18 18 7 18 18 7 18
7 3 3 7 4 4 7 5 5 7 16
20 20 2 2 20 20 3 3 20 20 16
0 0 0 0 0 0 0 0 0 0 0
0 0 0 0 0 0 0 0 0 0 0
0 0 0 0 0 0 0 0 0 0 0
0 0 0 0 0 0 0 0 0 0 0
0 0 0 0 0 0 0 0 0 0 0
0 0 0 0 0 0 0 0 0 0 0
0 0 0 0 0 0 0 0 0 0 0
0 0 0 0 0 0 0 0 0 0 0
0 0 0 0 0 0 0 0 0 0 0
0 0 0 0 0 0 0 0 0 0 0
0 0 0 0 0 0 0 0 0 0 0
0 0 0 0 0 0 0 0 0 0 0
0 0 0 0 0 0 0 0 0 0 0
0 0 0 0 0 0 0 0 0 0 0
0 0 0 0 0 0 0 0 0 0 0
0 0 0 0 0 0 0 0 0 0 0
0 0 0 0 0 0 0 0 0 0 0
0 0 0 0 0 0 0 0 0 0 0
0 0 0 0 0 0 0 0 0 0 0
0 0 0 0 0 0 0 0 0 0 0
0 0 0 0 0 0 0 0 0 0 0
0 0 0 0 0 0 0 0 0 0 0
0 0 0 0 0 0 0 0 0 0 0
0 0 0 0 0 0 0 0 0 0 0
0 0 0 0 0 0 0 0 0 0 0
0 0 0 0 0 0 0 0 0 0 0
0 0 0 0 0 0 0 0 0 0 0
0 0 0 0 0 0 0 0 0 0 0
0 0 0 0 0 0 0 0 0 0 0
0 0 0 0 0 0 0 0 0 0 0
0 0 0 0 0 0 0 0 0 0 0
0 0 0 0 0 0 0 0 0 0 0
0 0 0 0 0 0 0 0 0 0 0
0 0 0 0 0 0 0 0 0 0 0
0 0 0 0 0 0 0 0 0 0 0
0 0 0 0 0 0 0 0 0 0 0
0 0 0 0 0 0 0 0 0 0 0
0 0 0 0 0 0 0 0 0 0 0
0 0 0 0 0 0 0 0 0 0 0
0 0 0 0 0 0 0 0 0 0 0
0 0 0 0 0 0 0 0 0 0 0
0 0 0 0 0 0 0 0 0 0 0
0 0 0 0 0 0 0 0 0 0 0
0 0 0 0 0 0 0 0 0 0 0
0 0 0 0 0 0 0 0 0 0 0
0 0 0 0 0 0 0 0 0 0 0
0 0 0 0 0 0 0 0 0 0 0
0 0 0 0 0 0 0 0 0 0 0
0 0 0 0 0 0 0 0 0 0 0
0 0 0 0 0 0 0 0 0 0 0