MODE 2
SIZE 11/70
LIMIT 0/40
COLOR LIMIT 4
STARS 1000/2850/5000
POWERUPS 0/1/0/0
17 17 20 20 20 20 20 20 20 17 17
18 1 1 1 18 18 1 1 1 18 0
0 18 3 3 18 11 18 3 3 18 0
0 18 2 2 18 18 2 2 18 0 0
0 0 18 5 5 18 5 5 18 0 0
18 18 1 18 18 18 18 1 18 18 18
3 1 1 18 3 11 3 18 1 1 3
3 3 1 18 3 3 18 1 3 3 0
0 0 20 20 18 3 18 20 20 0 0
0 13 20 20 18 18 20 20 16 0 0
5 5 20 20 7 18 7 20 20 5 5
5 5 20 7 6 6 7 20 5 5 5
0 0 0 18 6 15 6 18 0 0 0
7 7 7 20 6 6 20 7 7 7 7
20 20 20 20 20 3 20 20 20 20 20
7 7 7 20 3 3 20 7 7 7 7
7 7 7 20 3 12 3 20 7 7 7
20 20 20 3 18 18 3 20 20 20 20
7 7 7 20 3 3 3 20 7 7 7
7 0 7 0 0 0 0 7 0 7 0
0 7 7 7 7 7 7 7 7 7 0
0 7 0 7 7 7 7 0 7 0 0
0 0 0 0 0 0 0 0 0 0 0
0 0 0 0 0 0 0 0 0 0 0
0 0 0 0 0 0 0 0 0 0 0
0 0 0 0 0 0 0 0 0 0 0
0 0 0 0 0 0 0 0 0 0 0
0 0 0 0 0 0 0 0 0 0 0
0 0 0 0 0 0 0 0 0 0 0
0 0 0 0 0 0 0 0 0 0 0
0 0 0 0 0 0 0 0 0 0 0
0 0 0 0 0 0 0 0 0 0 0
0 0 0 0 0 0 0 0 0 0 0
0 0 0 0 0 0 0 0 0 0 0
0 0 0 0 0 0 0 0 0 0 0
0 0 0 0 0 0 0 0 0 0 0
0 0 0 0 0 0 0 0 0 0 0
0 0 0 0 0 0 0 0 0 0 0
0 0 0 0 0 0 0 0 0 0 0
0 0 0 0 0 0 0 0 0 0 0
0 0 0 0 0 0 0 0 0 0 0
0 0 0 0 0 0 0 0 0 0 0
0 0 0 0 0 0 0 0 0 0 0
0 0 0 0 0 0 0 0 0 0 0
0 0 0 0 0 0 0 0 0 0 0
0 0 0 0 0 0 0 0 0 0 0
0 0 0 0 0 0 0 0 0 0 0
0 0 0 0 0 0 0 0 0 0 0
0 0 0 0 0 0 0 0 0 0 0
0 0 0 0 0 0 0 0 0 0 0
0 0 0 0 0 0 0 0 0 0 0
0 0 0 0 0 0 0 0 0 0 0
0 0 0 0 0 0 0 0 0 0 0
0 0 0 0 0 0 0 0 0 0 0
0 0 0 0 0 0 0 0 0 0 0
0 0 0 0 0 0 0 0 0 0 0
0 0 0 0 0 0 0 0 0 0 0
0 0 0 0 0 0 0 0 0 0 0
0 0 0 0 0 0 0 0 0 0 0
0 0 0 0 0 0 0 0 0 0 0
0 0 0 0 0 0 0 0 0 0 0
0 0 0 0 0 0 0 0 0 0 0
0 0 0 0 0 0 0 0 0 0 0
0 0 0 0 0 0 0 0 0 0 0
0 0 0 0 0 0 0 0 0 0 0
0 0 0 0 0 0 0 0 0 0 0
0 0 0 0 0 0 0 0 0 0 0
0 0 0 0 0 0 0 0 0 0 0
0 0 0 0 0 0 0 0 0 0 0
0 0 0 0 0 0 0 0 0 0 0