MODE 2
SIZE 11/70
LIMIT 0/40
COLOR LIMIT 4
STARS 1200/3600/7000
POWERUPS 0/1/0/0
3 3 3 3 3 20 3 3 3 3 3
3 4 4 4 20 20 4 4 4 3 0
1 18 18 18 18 5 18 18 18 18 1
1 3 11 20 5 5 20 12 3 1 0
0 1 3 20 5 1 5 20 3 1 0
0 1 20 5 1 1 5 20 1 0 0
0 1 20 20 1 4 1 20 20 1 0
1 20 17 20 4 4 20 17 20 1 0
1 20 17 1 20 4 20 1 17 20 1
20 17 1 13 20 20 13 1 17 20 0
20 20 20 20 20 20 20 20 20 20 20
5 5 5 5 5 5 5 5 1 5 5
0 1 3 3 3 3 3 3 3 1 5
1 5 2 2 2 2 2 2 2 1 0
1 1 1 1 1 1 1 1 1 1 1
20 20 5 3 4 12 4 3 5 20 20
20 14 20 5 3 4 4 3 5 20 17
20 20 0 5 3 4 3 5 0 20 20
3 3 3 3 5 4 4 5 3 3 3
0 0 0 0 5 0 5 0 0 0 0
20 20 20 20 20 5 20 20 20 20 20
0 20 20 20 0 5 0 20 20 20 0
0 0 0 0 0 0 0 0 0 0 0
0 0 0 0 0 0 0 0 0 0 0
0 0 0 0 0 0 0 0 0 0 0
0 0 0 0 0 0 0 0 0 0 0
0 0 0 0 0 0 0 0 0 0 0
0 0 0 0 0 0 0 0 0 0 0
0 0 0 0 0 0 0 0 0 0 0
0 0 0 0 0 0 0 0 0 0 0
0 0 0 0 0 0 0 0 0 0 0
0 0 0 0 0 0 0 0 0 0 0
0 0 0 0 0 0 0 0 0 0 0
0 0 0 0 0 0 0 0 0 0 0
0 0 0 0 0 0 0 0 0 0 0
0 0 0 0 0 0 0 0 0 0 0
0 0 0 0 0 0 0 0 0 0 0
0 0 0 0 0 0 0 0 0 0 0
0 0 0 0 0 0 0 0 0 0 0
0 0 0 0 0 0 0 0 0 0 0
0 0 0 0 0 0 0 0 0 0 0
0 0 0 0 0 0 0 0 0 0 0
0 0 0 0 0 0 0 0 0 0 0
0 0 0 0 0 0 0 0 0 0 0
0 0 0 0 0 0 0 0 0 0 0
0 0 0 0 0 0 0 0 0 0 0
0 0 0 0 0 0 0 0 0 0 0
0 0 0 0 0 0 0 0 0 0 0
0 0 0 0 0 0 0 0 0 0 0
0 0 0 0 0 0 0 0 0 0 0
0 0 0 0 0 0 0 0 0 0 0
0 0 0 0 0 0 0 0 0 0 0
0 0 0 0 0 0 0 0 0 0 0
0 0 0 0 0 0 0 0 0 0 0
0 0 0 0 0 0 0 0 0 0 0
0 0 0 0 0 0 0 0 0 0 0
0 0 0 0 0 0 0 0 0 0 0
0 0 0 0 0 0 0 0 0 0 0
0 0 0 0 0 0 0 0 0 0 0
0 0 0 0 0 0 0 0 0 0 0
0 0 0 0 0 0 0 0 0 0 0
0 0 0 0 0 0 0 0 0 0 0
0 0 0 0 0 0 0 0 0 0 0
0 0 0 0 0 0 0 0 0 0 0
0 0 0 0 0 0 0 0 0 0 0
0 0 0 0 0 0 0 0 0 0 0
0 0 0 0 0 0 0 0 0 0 0
0 0 0 0 0 0 0 0 0 0 0
0 0 0 0 0 0 0 0 0 0 0
0 0 0 0 0 0 0 0 0 0 0