MODE 2
SIZE 11/70
LIMIT 0/50
COLOR LIMIT 4
STARS 3900/7200/11000
POWERUPS 1/1/0/0
7 3 5 5 5 13 5 5 5 3 7
7 3 20 17 5 5 17 20 3 7 7
7 7 4 3 2 5 2 3 4 7 7
7 7 8 3 2 2 3 8 7 7 1
1 7 7 4 20 17 20 4 7 7 1
1 7 7 3 2 2 3 7 7 3 0
0 3 7 7 2 18 2 7 7 1 0
0 1 7 7 18 18 7 7 1 0 0
0 0 1 7 18 11 18 7 3 0 0
0 1 7 7 18 18 7 7 1 0 0
0 3 7 7 2 18 2 7 7 1 0
1 7 7 3 2 2 3 7 7 3 0
1 7 7 4 20 17 20 4 7 7 1
7 7 8 3 2 2 3 8 7 7 1
7 7 4 3 2 5 2 3 4 7 7
7 3 20 17 5 5 17 20 3 7 7
7 3 5 5 5 12 5 5 5 3 7
7 18 20 20 20 20 20 20 18 7 7
7 7 18 20 20 20 20 20 18 7 7
7 7 7 18 18 18 18 7 7 7 0
0 7 0 0 7 14 7 0 0 7 0
0 0 0 0 7 7 0 0 0 0 0
0 0 0 0 0 0 0 0 0 0 0
0 0 0 0 0 0 0 0 0 0 0
0 0 0 0 0 0 0 0 0 0 0
0 0 0 0 0 0 0 0 0 0 0
0 0 0 0 0 0 0 0 0 0 0
0 0 0 0 0 0 0 0 0 0 0
0 0 0 0 0 0 0 0 0 0 0
0 0 0 0 0 0 0 0 0 0 0
0 0 0 0 0 0 0 0 0 0 0
0 0 0 0 0 0 0 0 0 0 0
0 0 0 0 0 0 0 0 0 0 0
0 0 0 0 0 0 0 0 0 0 0
0 0 0 0 0 0 0 0 0 0 0
0 0 0 0 0 0 0 0 0 0 0
0 0 0 0 0 0 0 0 0 0 0
0 0 0 0 0 0 0 0 0 0 0
0 0 0 0 0 0 0 0 0 0 0
0 0 0 0 0 0 0 0 0 0 0
0 0 0 0 0 0 0 0 0 0 0
0 0 0 0 0 0 0 0 0 0 0
0 0 0 0 0 0 0 0 0 0 0
0 0 0 0 0 0 0 0 0 0 0
0 0 0 0 0 0 0 0 0 0 0
0 0 0 0 0 0 0 0 0 0 0
0 0 0 0 0 0 0 0 0 0 0
0 0 0 0 0 0 0 0 0 0 0
0 0 0 0 0 0 0 0 0 0 0
0 0 0 0 0 0 0 0 0 0 0
0 0 0 0 0 0 0 0 0 0 0
0 0 0 0 0 0 0 0 0 0 0
0 0 0 0 0 0 0 0 0 0 0
0 0 0 0 0 0 0 0 0 0 0
0 0 0 0 0 0 0 0 0 0 0
0 0 0 0 0 0 0 0 0 0 0
0 0 0 0 0 0 0 0 0 0 0
0 0 0 0 0 0 0 0 0 0 0
0 0 0 0 0 0 0 0 0 0 0
0 0 0 0 0 0 0 0 0 0 0
0 0 0 0 0 0 0 0 0 0 0
0 0 0 0 0 0 0 0 0 0 0
0 0 0 0 0 0 0 0 0 0 0
0 0 0 0 0 0 0 0 0 0 0
0 0 0 0 0 0 0 0 0 0 0
0 0 0 0 0 0 0 0 0 0 0
0 0 0 0 0 0 0 0 0 0 0
0 0 0 0 0 0 0 0 0 0 0
0 0 0 0 0 0 0 0 0 0 0
0 0 0 0 0 0 0 0 0 0 0