MODE 2
SIZE 11/70
LIMIT 0/50
COLOR LIMIT 4
STARS 2600/5600/8200
POWERUPS 1/1/0/0
3 3 3 0 7 18 7 0 2 2 2
11 18 0 0 7 7 0 0 18 14 0
3 3 3 7 7 7 7 7 2 2 2
20 20 0 0 7 7 0 0 20 20 0
1 1 1 7 7 18 7 7 3 3 3
8 18 0 0 7 7 0 0 18 8 0
1 1 1 7 7 7 7 7 3 3 3
20 20 0 0 7 7 0 0 20 20 0
5 5 5 7 7 18 7 7 2 2 2
13 18 0 0 7 7 0 0 18 11 0
5 5 5 7 7 7 7 7 2 2 2
20 20 0 0 7 7 0 0 20 20 0
3 3 3 7 7 18 7 7 5 5 5
8 18 0 0 7 7 0 0 18 12 0
3 3 3 7 7 7 7 7 5 5 5
20 20 0 0 7 7 0 0 20 20 0
1 1 1 7 7 18 7 7 4 4 4
10 18 0 0 7 7 0 0 18 8 0
1 1 1 7 7 7 7 7 4 4 4
20 20 0 0 7 7 0 0 20 20 0
2 2 2 7 7 18 7 7 3 3 3
13 18 0 0 7 7 0 0 18 12 0
2 2 2 7 7 7 7 7 3 3 3
20 20 0 0 18 18 0 0 20 20 0
0 0 0 0 0 0 0 0 0 0 0
0 0 0 0 0 0 0 0 0 0 0
0 0 0 0 0 0 0 0 0 0 0
0 0 0 0 0 0 0 0 0 0 0
0 0 0 0 0 0 0 0 0 0 0
0 0 0 0 0 0 0 0 0 0 0
0 0 0 0 0 0 0 0 0 0 0
0 0 0 0 0 0 0 0 0 0 0
0 0 0 0 0 0 0 0 0 0 0
0 0 0 0 0 0 0 0 0 0 0
0 0 0 0 0 0 0 0 0 0 0
0 0 0 0 0 0 0 0 0 0 0
0 0 0 0 0 0 0 0 0 0 0
0 0 0 0 0 0 0 0 0 0 0
0 0 0 0 0 0 0 0 0 0 0
0 0 0 0 0 0 0 0 0 0 0
0 0 0 0 0 0 0 0 0 0 0
0 0 0 0 0 0 0 0 0 0 0
0 0 0 0 0 0 0 0 0 0 0
0 0 0 0 0 0 0 0 0 0 0
0 0 0 0 0 0 0 0 0 0 0
0 0 0 0 0 0 0 0 0 0 0
0 0 0 0 0 0 0 0 0 0 0
0 0 0 0 0 0 0 0 0 0 0
0 0 0 0 0 0 0 0 0 0 0
0 0 0 0 0 0 0 0 0 0 0
0 0 0 0 0 0 0 0 0 0 0
0 0 0 0 0 0 0 0 0 0 0
0 0 0 0 0 0 0 0 0 0 0
0 0 0 0 0 0 0 0 0 0 0
0 0 0 0 0 0 0 0 0 0 0
0 0 0 0 0 0 0 0 0 0 0
0 0 0 0 0 0 0 0 0 0 0
0 0 0 0 0 0 0 0 0 0 0
0 0 0 0 0 0 0 0 0 0 0
0 0 0 0 0 0 0 0 0 0 0
0 0 0 0 0 0 0 0 0 0 0
0 0 0 0 0 0 0 0 0 0 0
0 0 0 0 0 0 0 0 0 0 0
0 0 0 0 0 0 0 0 0 0 0
0 0 0 0 0 0 0 0 0 0 0
0 0 0 0 0 0 0 0 0 0 0
0 0 0 0 0 0 0 0 0 0 0
0 0 0 0 0 0 0 0 0 0 0
0 0 0 0 0 0 0 0 0 0 0
0 0 0 0 0 0 0 0 0 0 0