MODE 2
SIZE 11/70
LIMIT 0/48
COLOR LIMIT 4
STARS 2600/5200/8200
POWERUPS 0/0/0/0
17 17 17 0 0 17 0 0 17 17 17
0 1 17 1 1 3 3 17 3 0 0
0 1 2 17 2 1 2 17 2 3 0
1 2 17 11 3 1 13 17 2 3 0
0 1 2 2 2 3 2 2 2 3 0
0 1 1 1 1 14 3 3 3 0 0
0 0 20 20 20 20 20 20 20 20 0
0 20 2 3 1 5 1 2 3 5 0
0 20 2 3 1 5 18 1 2 3 5
20 2 3 1 5 18 18 1 2 3 5
0 20 2 3 1 5 12 1 2 3 5
0 20 2 3 1 5 20 2 3 5 0
0 3 20 2 2 2 20 5 5 3 0
3 1 20 20 20 20 0 0 1 3 0
3 1 4 3 3 18 3 3 4 1 3
1 4 5 3 18 18 3 5 4 1 0
0 4 5 20 3 15 3 20 5 4 0
0 5 20 18 3 3 18 20 5 0 0
0 0 20 7 18 3 18 7 20 0 0
20 20 7 7 18 18 7 7 20 20 0
7 7 7 7 7 7 7 7 7 7 7
0 7 7 7 7 7 7 7 7 0 0
0 0 0 7 7 7 7 7 0 0 0
0 0 0 0 0 0 0 0 0 0 0
0 0 0 0 0 0 0 0 0 0 0
0 0 0 0 0 0 0 0 0 0 0
0 0 0 0 0 0 0 0 0 0 0
0 0 0 0 0 0 0 0 0 0 0
0 0 0 0 0 0 0 0 0 0 0
0 0 0 0 0 0 0 0 0 0 0
0 0 0 0 0 0 0 0 0 0 0
0 0 0 0 0 0 0 0 0 0 0
0 0 0 0 0 0 0 0 0 0 0
0 0 0 0 0 0 0 0 0 0 0
0 0 0 0 0 0 0 0 0 0 0
0 0 0 0 0 0 0 0 0 0 0
0 0 0 0 0 0 0 0 0 0 0
0 0 0 0 0 0 0 0 0 0 0
0 0 0 0 0 0 0 0 0 0 0
0 0 0 0 0 0 0 0 0 0 0
0 0 0 0 0 0 0 0 0 0 0
0 0 0 0 0 0 0 0 0 0 0
0 0 0 0 0 0 0 0 0 0 0
0 0 0 0 0 0 0 0 0 0 0
0 0 0 0 0 0 0 0 0 0 0
0 0 0 0 0 0 0 0 0 0 0
0 0 0 0 0 0 0 0 0 0 0
0 0 0 0 0 0 0 0 0 0 0
0 0 0 0 0 0 0 0 0 0 0
0 0 0 0 0 0 0 0 0 0 0
0 0 0 0 0 0 0 0 0 0 0
0 0 0 0 0 0 0 0 0 0 0
0 0 0 0 0 0 0 0 0 0 0
0 0 0 0 0 0 0 0 0 0 0
0 0 0 0 0 0 0 0 0 0 0
0 0 0 0 0 0 0 0 0 0 0
0 0 0 0 0 0 0 0 0 0 0
0 0 0 0 0 0 0 0 0 0 0
0 0 0 0 0 0 0 0 0 0 0
0 0 0 0 0 0 0 0 0 0 0
0 0 0 0 0 0 0 0 0 0 0
0 0 0 0 0 0 0 0 0 0 0
0 0 0 0 0 0 0 0 0 0 0
0 0 0 0 0 0 0 0 0 0 0
0 0 0 0 0 0 0 0 0 0 0
0 0 0 0 0 0 0 0 0 0 0
0 0 0 0 0 0 0 0 0 0 0
0 0 0 0 0 0 0 0 0 0 0
0 0 0 0 0 0 0 0 0 0 0
0 0 0 0 0 0 0 0 0 0 0