MODE 2
SIZE 11/70
LIMIT 0/42
COLOR LIMIT 4
STARS 2100/4200/7300
POWERUPS 0/0/0/0
0 0 0 0 0 17 0 0 0 0 0
3 3 3 3 17 0 3 3 3 3 0
3 1 1 17 17 17 17 17 1 1 3
3 3 3 3 11 17 3 3 3 3 0
20 20 20 5 5 17 5 5 20 20 20
0 20 2 17 17 17 17 2 20 0 0
0 20 2 5 18 1 18 5 2 20 0
20 2 0 5 1 1 5 0 2 20 0
3 15 3 3 5 12 5 3 3 15 3
2 0 0 1 1 1 1 0 0 2 0
2 3 3 3 3 5 3 3 3 3 2
2 0 1 1 20 20 1 1 0 2 0
0 2 2 2 1 13 1 2 2 2 0
1 1 1 1 20 20 1 1 1 1 1
20 20 20 0 20 6 20 0 20 20 20
3 3 20 20 6 6 20 20 3 3 0
5 5 3 20 6 12 6 20 3 5 5
17 5 3 20 6 6 20 3 5 17 0
1 1 5 3 5 1 5 3 5 1 1
0 1 18 5 1 1 5 18 1 0 0
0 0 18 1 1 0 1 1 18 0 0
0 0 0 0 0 0 0 0 0 0 0
0 0 0 0 0 0 0 0 0 0 0
0 0 0 0 0 0 0 0 0 0 0
0 0 0 0 0 0 0 0 0 0 0
0 0 0 0 0 0 0 0 0 0 0
0 0 0 0 0 0 0 0 0 0 0
0 0 0 0 0 0 0 0 0 0 0
0 0 0 0 0 0 0 0 0 0 0
0 0 0 0 0 0 0 0 0 0 0
0 0 0 0 0 0 0 0 0 0 0
0 0 0 0 0 0 0 0 0 0 0
0 0 0 0 0 0 0 0 0 0 0
0 0 0 0 0 0 0 0 0 0 0
0 0 0 0 0 0 0 0 0 0 0
0 0 0 0 0 0 0 0 0 0 0
0 0 0 0 0 0 0 0 0 0 0
0 0 0 0 0 0 0 0 0 0 0
0 0 0 0 0 0 0 0 0 0 0
0 0 0 0 0 0 0 0 0 0 0
0 0 0 0 0 0 0 0 0 0 0
0 0 0 0 0 0 0 0 0 0 0
0 0 0 0 0 0 0 0 0 0 0
0 0 0 0 0 0 0 0 0 0 0
0 0 0 0 0 0 0 0 0 0 0
0 0 0 0 0 0 0 0 0 0 0
0 0 0 0 0 0 0 0 0 0 0
0 0 0 0 0 0 0 0 0 0 0
0 0 0 0 0 0 0 0 0 0 0
0 0 0 0 0 0 0 0 0 0 0
0 0 0 0 0 0 0 0 0 0 0
0 0 0 0 0 0 0 0 0 0 0
0 0 0 0 0 0 0 0 0 0 0
0 0 0 0 0 0 0 0 0 0 0
0 0 0 0 0 0 0 0 0 0 0
0 0 0 0 0 0 0 0 0 0 0
0 0 0 0 0 0 0 0 0 0 0
0 0 0 0 0 0 0 0 0 0 0
0 0 0 0 0 0 0 0 0 0 0
0 0 0 0 0 0 0 0 0 0 0
0 0 0 0 0 0 0 0 0 0 0
0 0 0 0 0 0 0 0 0 0 0
0 0 0 0 0 0 0 0 0 0 0
0 0 0 0 0 0 0 0 0 0 0
0 0 0 0 0 0 0 0 0 0 0
0 0 0 0 0 0 0 0 0 0 0
0 0 0 0 0 0 0 0 0 0 0
0 0 0 0 0 0 0 0 0 0 0
0 0 0 0 0 0 0 0 0 0 0
0 0 0 0 0 0 0 0 0 0 0