MODE 2
SIZE 11/70
LIMIT 0/45
COLOR LIMIT 4
STARS 2500/5900/8600
POWERUPS 1/1/0/0
0 0 17 17 17 17 17 17 17 0 0
0 0 0 0 17 17 0 0 0 0 0
0 0 0 0 17 18 17 0 0 0 0
0 3 3 17 18 18 17 3 3 0 0
0 3 11 17 3 18 3 17 11 3 0
3 17 17 2 3 3 2 17 17 3 0
1 3 2 2 3 1 3 2 2 3 1
1 3 3 20 1 1 20 3 3 1 0
0 1 1 1 20 5 20 1 1 1 0
0 0 0 20 5 5 20 0 0 0 0
20 20 20 20 20 12 5 20 20 20 20
3 3 3 5 5 5 5 3 3 3 0
17 18 15 20 20 20 20 20 14 18 17
1 1 1 3 3 3 3 1 1 1 0
17 0 0 20 3 4 3 20 0 0 17
5 5 5 20 3 4 20 5 5 5 0
17 18 13 20 4 3 4 20 13 18 17
2 2 2 4 4 4 4 2 2 2 0
17 0 0 20 20 20 20 20 0 0 17
3 3 3 1 1 1 1 3 3 3 0
17 18 16 20 1 2 1 20 15 18 17
4 4 4 20 2 1 20 4 4 4 0
17 0 0 20 2 1 2 20 0 0 17
1 1 1 2 2 2 2 1 1 1 0
17 18 14 20 20 20 20 20 15 18 17
6 6 6 3 3 3 3 6 6 6 0
17 0 0 20 3 5 3 20 0 0 17
1 1 1 20 3 5 20 1 1 1 0
17 18 16 20 5 3 5 20 14 18 17
2 2 2 5 5 5 5 2 2 2 0
17 0 0 20 20 20 20 20 0 0 17
3 3 3 0 0 0 0 3 3 3 0
0 0 0 0 0 0 0 0 0 0 0
0 0 0 0 0 0 0 0 0 0 0
0 0 0 0 0 0 0 0 0 0 0
0 0 0 0 0 0 0 0 0 0 0
0 0 0 0 0 0 0 0 0 0 0
0 0 0 0 0 0 0 0 0 0 0
0 0 0 0 0 0 0 0 0 0 0
0 0 0 0 0 0 0 0 0 0 0
0 0 0 0 0 0 0 0 0 0 0
0 0 0 0 0 0 0 0 0 0 0
0 0 0 0 0 0 0 0 0 0 0
0 0 0 0 0 0 0 0 0 0 0
0 0 0 0 0 0 0 0 0 0 0
0 0 0 0 0 0 0 0 0 0 0
0 0 0 0 0 0 0 0 0 0 0
0 0 0 0 0 0 0 0 0 0 0
0 0 0 0 0 0 0 0 0 0 0
0 0 0 0 0 0 0 0 0 0 0
0 0 0 0 0 0 0 0 0 0 0
0 0 0 0 0 0 0 0 0 0 0
0 0 0 0 0 0 0 0 0 0 0
0 0 0 0 0 0 0 0 0 0 0
0 0 0 0 0 0 0 0 0 0 0
0 0 0 0 0 0 0 0 0 0 0
0 0 0 0 0 0 0 0 0 0 0
0 0 0 0 0 0 0 0 0 0 0
0 0 0 0 0 0 0 0 0 0 0
0 0 0 0 0 0 0 0 0 0 0
0 0 0 0 0 0 0 0 0 0 0
0 0 0 0 0 0 0 0 0 0 0
0 0 0 0 0 0 0 0 0 0 0
0 0 0 0 0 0 0 0 0 0 0
0 0 0 0 0 0 0 0 0 0 0
0 0 0 0 0 0 0 0 0 0 0
0 0 0 0 0 0 0 0 0 0 0
0 0 0 0 0 0 0 0 0 0 0
0 0 0 0 0 0 0 0 0 0 0
0 0 0 0 0 0 0 0 0 0 0