MODE 2
SIZE 11/70
LIMIT 0/35
COLOR LIMIT 4
STARS 2100/5300/9000
POWERUPS 1/1/0/0
17 17 17 17 18 18 18 17 17 17 17
0 17 0 0 18 18 0 0 17 0 0
0 20 20 20 3 3 3 20 20 20 0
0 20 3 20 20 20 20 3 20 0 0
20 20 20 20 1 13 1 20 20 20 20
0 0 3 2 1 1 2 3 0 0 0
0 0 0 2 2 1 2 2 0 0 0
20 20 20 3 2 2 3 20 20 20 0
20 18 2 18 3 8 3 18 2 18 20
20 2 2 2 3 3 2 2 2 20 0
0 20 1 1 18 3 18 1 1 20 0
20 18 14 1 18 18 1 12 18 20 0
20 20 5 5 5 1 5 5 5 20 20
0 20 5 3 1 3 3 5 20 0 0
0 0 20 5 1 15 3 5 20 0 0
0 0 20 1 3 3 5 20 0 0 0
0 0 3 1 5 3 5 1 3 0 0
0 3 1 4 5 5 4 1 3 0 0
0 3 18 4 11 5 11 4 18 3 0
3 1 4 4 4 4 4 4 1 3 0
3 1 1 1 1 18 1 1 1 1 3
7 7 7 7 0 0 7 7 7 7 0
0 7 7 7 7 0 7 7 7 7 0
0 17 17 7 18 18 7 17 17 0 0
0 17 7 7 18 8 18 7 7 17 0
17 0 7 7 7 18 7 7 0 17 0
17 0 0 7 7 7 7 7 0 0 17
0 0 20 7 7 7 7 20 0 0 0
0 0 0 18 20 18 20 18 0 0 0
0 0 0 0 0 0 0 0 0 0 0
0 0 0 0 0 0 0 0 0 0 0
0 0 0 0 0 0 0 0 0 0 0
0 0 0 0 0 0 0 0 0 0 0
0 0 0 0 0 0 0 0 0 0 0
0 0 0 0 0 0 0 0 0 0 0
0 0 0 0 0 0 0 0 0 0 0
0 0 0 0 0 0 0 0 0 0 0
0 0 0 0 0 0 0 0 0 0 0
0 0 0 0 0 0 0 0 0 0 0
0 0 0 0 0 0 0 0 0 0 0
0 0 0 0 0 0 0 0 0 0 0
0 0 0 0 0 0 0 0 0 0 0
0 0 0 0 0 0 0 0 0 0 0
0 0 0 0 0 0 0 0 0 0 0
0 0 0 0 0 0 0 0 0 0 0
0 0 0 0 0 0 0 0 0 0 0
0 0 0 0 0 0 0 0 0 0 0
0 0 0 0 0 0 0 0 0 0 0
0 0 0 0 0 0 0 0 0 0 0
0 0 0 0 0 0 0 0 0 0 0
0 0 0 0 0 0 0 0 0 0 0
0 0 0 0 0 0 0 0 0 0 0
0 0 0 0 0 0 0 0 0 0 0
0 0 0 0 0 0 0 0 0 0 0
0 0 0 0 0 0 0 0 0 0 0
0 0 0 0 0 0 0 0 0 0 0
0 0 0 0 0 0 0 0 0 0 0
0 0 0 0 0 0 0 0 0 0 0
0 0 0 0 0 0 0 0 0 0 0
0 0 0 0 0 0 0 0 0 0 0
0 0 0 0 0 0 0 0 0 0 0
0 0 0 0 0 0 0 0 0 0 0
0 0 0 0 0 0 0 0 0 0 0
0 0 0 0 0 0 0 0 0 0 0
0 0 0 0 0 0 0 0 0 0 0
0 0 0 0 0 0 0 0 0 0 0
0 0 0 0 0 0 0 0 0 0 0
0 0 0 0 0 0 0 0 0 0 0
0 0 0 0 0 0 0 0 0 0 0
0 0 0 0 0 0 0 0 0 0 0