MODE 2
SIZE 11/70
LIMIT 0/35
COLOR LIMIT 4
STARS 1200/4300/7500
POWERUPS 1/1/0/0
17 17 0 0 0 3 0 0 0 17 17
17 0 0 7 7 7 7 0 0 17 0
17 1 0 7 3 11 3 7 0 1 17
1 7 7 3 20 20 3 7 7 1 0
1 1 1 3 1 1 1 3 1 1 1
0 0 3 17 2 2 17 3 0 0 0
0 0 3 17 3 3 3 17 3 0 0
17 17 17 5 18 18 5 17 17 17 17
5 5 5 5 18 13 18 5 5 5 5
0 5 5 20 18 18 20 5 5 0 0
0 20 20 20 5 2 5 20 20 20 0
20 5 1 1 2 2 1 1 1 20 0
20 5 5 5 1 2 1 5 5 5 20
20 20 20 20 3 3 20 20 20 20 0
0 0 0 20 2 1 2 20 0 0 0
0 0 20 3 2 2 3 20 0 0 0
0 0 20 3 3 2 3 3 20 0 0
0 20 3 20 1 1 20 3 20 0 0
20 20 1 20 1 15 1 20 1 20 20
3 3 1 20 1 1 20 1 3 3 0
1 1 1 18 20 12 20 18 1 1 1
20 20 20 20 0 0 20 20 20 20 20
7 7 7 7 0 0 0 7 7 7 7
18 8 7 7 7 7 7 7 8 18 0
7 7 7 7 18 7 18 7 7 7 7
0 0 18 7 7 7 7 18 0 0 0
0 0 7 7 7 7 7 7 7 0 0
0 0 0 0 7 7 0 0 0 0 0
0 0 0 0 0 7 0 0 0 0 0
0 0 0 0 0 0 0 0 0 0 0
0 0 0 0 0 0 0 0 0 0 0
0 0 0 0 0 0 0 0 0 0 0
0 0 0 0 0 0 0 0 0 0 0
0 0 0 0 0 0 0 0 0 0 0
0 0 0 0 0 0 0 0 0 0 0
0 0 0 0 0 0 0 0 0 0 0
0 0 0 0 0 0 0 0 0 0 0
0 0 0 0 0 0 0 0 0 0 0
0 0 0 0 0 0 0 0 0 0 0
0 0 0 0 0 0 0 0 0 0 0
0 0 0 0 0 0 0 0 0 0 0
0 0 0 0 0 0 0 0 0 0 0
0 0 0 0 0 0 0 0 0 0 0
0 0 0 0 0 0 0 0 0 0 0
0 0 0 0 0 0 0 0 0 0 0
0 0 0 0 0 0 0 0 0 0 0
0 0 0 0 0 0 0 0 0 0 0
0 0 0 0 0 0 0 0 0 0 0
0 0 0 0 0 0 0 0 0 0 0
0 0 0 0 0 0 0 0 0 0 0
0 0 0 0 0 0 0 0 0 0 0
0 0 0 0 0 0 0 0 0 0 0
0 0 0 0 0 0 0 0 0 0 0
0 0 0 0 0 0 0 0 0 0 0
0 0 0 0 0 0 0 0 0 0 0
0 0 0 0 0 0 0 0 0 0 0
0 0 0 0 0 0 0 0 0 0 0
0 0 0 0 0 0 0 0 0 0 0
0 0 0 0 0 0 0 0 0 0 0
0 0 0 0 0 0 0 0 0 0 0
0 0 0 0 0 0 0 0 0 0 0
0 0 0 0 0 0 0 0 0 0 0
0 0 0 0 0 0 0 0 0 0 0
0 0 0 0 0 0 0 0 0 0 0
0 0 0 0 0 0 0 0 0 0 0
0 0 0 0 0 0 0 0 0 0 0
0 0 0 0 0 0 0 0 0 0 0
0 0 0 0 0 0 0 0 0 0 0
0 0 0 0 0 0 0 0 0 0 0
0 0 0 0 0 0 0 0 0 0 0