MODE 2
SIZE 11/70
LIMIT 0/45
COLOR LIMIT 4
STARS 1800/4300/7600
POWERUPS 0/0/0/0
1 1 1 1 3 6 3 1 1 1 1
1 13 18 3 6 6 3 18 13 1 0
0 1 18 3 6 18 6 3 18 1 0
0 1 20 5 18 18 5 20 1 0 0
3 3 3 6 5 11 5 6 3 3 3
6 6 6 0 20 20 0 6 6 6 6
5 5 2 5 5 17 5 5 2 5 5
20 2 2 0 1 1 0 2 2 20 0
20 20 20 2 1 17 1 2 20 20 20
2 18 18 1 20 20 1 18 18 2 0
2 2 2 1 2 16 2 1 2 2 2
20 20 20 1 20 20 1 20 20 20 0
0 0 20 3 1 18 1 3 20 0 0
0 20 3 3 18 18 3 3 20 0 0
0 20 3 6 6 6 6 6 3 20 0
20 3 3 7 3 3 7 3 3 20 0
0 0 0 7 6 15 6 7 0 0 0
7 7 7 18 6 6 18 7 7 7 7
7 7 7 18 18 6 18 18 7 7 7
0 7 20 7 7 7 7 20 7 0 0
0 0 20 7 7 7 7 7 20 0 0
0 0 7 7 20 20 7 7 0 0 0
0 0 0 0 0 0 0 0 0 0 0
0 0 0 0 0 0 0 0 0 0 0
0 0 0 0 0 0 0 0 0 0 0
0 0 0 0 0 0 0 0 0 0 0
0 0 0 0 0 0 0 0 0 0 0
0 0 0 0 0 0 0 0 0 0 0
0 0 0 0 0 0 0 0 0 0 0
0 0 0 0 0 0 0 0 0 0 0
0 0 0 0 0 0 0 0 0 0 0
0 0 0 0 0 0 0 0 0 0 0
0 0 0 0 0 0 0 0 0 0 0
0 0 0 0 0 0 0 0 0 0 0
0 0 0 0 0 0 0 0 0 0 0
0 0 0 0 0 0 0 0 0 0 0
0 0 0 0 0 0 0 0 0 0 0
0 0 0 0 0 0 0 0 0 0 0
0 0 0 0 0 0 0 0 0 0 0
0 0 0 0 0 0 0 0 0 0 0
0 0 0 0 0 0 0 0 0 0 0
0 0 0 0 0 0 0 0 0 0 0
0 0 0 0 0 0 0 0 0 0 0
0 0 0 0 0 0 0 0 0 0 0
0 0 0 0 0 0 0 0 0 0 0
0 0 0 0 0 0 0 0 0 0 0
0 0 0 0 0 0 0 0 0 0 0
0 0 0 0 0 0 0 0 0 0 0
0 0 0 0 0 0 0 0 0 0 0
0 0 0 0 0 0 0 0 0 0 0
0 0 0 0 0 0 0 0 0 0 0
0 0 0 0 0 0 0 0 0 0 0
0 0 0 0 0 0 0 0 0 0 0
0 0 0 0 0 0 0 0 0 0 0
0 0 0 0 0 0 0 0 0 0 0
0 0 0 0 0 0 0 0 0 0 0
0 0 0 0 0 0 0 0 0 0 0
0 0 0 0 0 0 0 0 0 0 0
0 0 0 0 0 0 0 0 0 0 0
0 0 0 0 0 0 0 0 0 0 0
0 0 0 0 0 0 0 0 0 0 0
0 0 0 0 0 0 0 0 0 0 0
0 0 0 0 0 0 0 0 0 0 0
0 0 0 0 0 0 0 0 0 0 0
0 0 0 0 0 0 0 0 0 0 0
0 0 0 0 0 0 0 0 0 0 0
0 0 0 0 0 0 0 0 0 0 0
0 0 0 0 0 0 0 0 0 0 0
0 0 0 0 0 0 0 0 0 0 0
0 0 0 0 0 0 0 0 0 0 0