MODE 2
SIZE 11/70
LIMIT 0/60
COLOR LIMIT 4
STARS 3600/6500/10000
POWERUPS 0/0/0/0
0 0 17 3 0 0 0 3 17 0 0
17 17 3 1 1 1 1 3 17 17 0
0 0 17 3 0 2 0 3 17 0 0
0 17 3 0 2 2 0 3 17 0 0
0 17 1 1 1 1 2 1 1 17 0
17 3 5 2 13 18 2 5 3 17 0
17 3 5 2 2 2 2 2 5 3 17
18 5 5 5 5 20 5 5 5 18 0
0 18 18 5 5 20 5 5 18 18 0
18 5 1 1 1 1 1 1 5 18 0
0 0 5 1 6 14 6 1 5 0 0
20 20 5 1 6 6 1 5 20 20 0
3 3 20 3 1 3 3 3 20 3 3
0 6 20 15 1 1 15 20 6 0 0
0 2 2 20 6 1 6 20 2 2 0
6 6 1 20 20 20 20 1 6 6 0
6 3 1 2 18 2 18 2 1 3 6
3 3 6 6 20 20 6 6 3 3 0
3 20 3 3 20 0 20 3 3 20 3
20 20 20 20 0 0 20 20 20 20 0
20 6 0 0 0 12 0 0 0 6 20
20 6 3 3 3 3 3 3 6 20 0
20 18 6 6 6 6 6 6 3 18 20
18 3 4 4 4 4 1 4 3 18 0
18 0 3 4 1 1 1 4 3 0 18
0 20 3 1 1 1 4 3 20 0 0
0 20 0 3 4 1 4 4 0 20 0
20 0 0 3 4 4 3 0 0 20 0
20 0 0 0 3 11 3 0 0 0 20
0 0 0 0 3 3 0 0 0 0 0
0 0 0 0 0 3 0 0 0 0 0
0 0 0 0 0 0 0 0 0 0 0
0 0 0 0 0 0 0 0 0 0 0
0 0 0 0 0 0 0 0 0 0 0
0 0 0 0 0 0 0 0 0 0 0
0 0 0 0 0 0 0 0 0 0 0
0 0 0 0 0 0 0 0 0 0 0
0 0 0 0 0 0 0 0 0 0 0
0 0 0 0 0 0 0 0 0 0 0
0 0 0 0 0 0 0 0 0 0 0
0 0 0 0 0 0 0 0 0 0 0
0 0 0 0 0 0 0 0 0 0 0
0 0 0 0 0 0 0 0 0 0 0
0 0 0 0 0 0 0 0 0 0 0
0 0 0 0 0 0 0 0 0 0 0
0 0 0 0 0 0 0 0 0 0 0
0 0 0 0 0 0 0 0 0 0 0
0 0 0 0 0 0 0 0 0 0 0
0 0 0 0 0 0 0 0 0 0 0
0 0 0 0 0 0 0 0 0 0 0
0 0 0 0 0 0 0 0 0 0 0
0 0 0 0 0 0 0 0 0 0 0
0 0 0 0 0 0 0 0 0 0 0
0 0 0 0 0 0 0 0 0 0 0
0 0 0 0 0 0 0 0 0 0 0
0 0 0 0 0 0 0 0 0 0 0
0 0 0 0 0 0 0 0 0 0 0
0 0 0 0 0 0 0 0 0 0 0
0 0 0 0 0 0 0 0 0 0 0
0 0 0 0 0 0 0 0 0 0 0
0 0 0 0 0 0 0 0 0 0 0
0 0 0 0 0 0 0 0 0 0 0
0 0 0 0 0 0 0 0 0 0 0
0 0 0 0 0 0 0 0 0 0 0
0 0 0 0 0 0 0 0 0 0 0
0 0 0 0 0 0 0 0 0 0 0
0 0 0 0 0 0 0 0 0 0 0
0 0 0 0 0 0 0 0 0 0 0
0 0 0 0 0 0 0 0 0 0 0
0 0 0 0 0 0 0 0 0 0 0