MODE 2
SIZE 11/70
LIMIT 0/70
COLOR LIMIT 4
STARS 3600/7500/10600
POWERUPS 1/1/1/1
17 17 0 0 6 5 6 0 0 17 17
3 6 0 6 5 5 6 0 6 3 0
0 3 6 18 5 11 5 18 6 3 0
0 3 6 5 4 7 5 6 3 0 0
0 0 3 6 7 4 7 6 3 0 0
0 0 5 14 7 4 16 5 0 0 0
0 0 5 3 7 7 4 3 5 0 0
0 5 6 3 7 4 3 6 5 0 0
0 5 6 2 20 4 20 2 6 5 0
5 6 2 5 3 3 5 2 6 5 0
5 18 2 5 18 3 18 5 2 18 5
1 6 2 5 18 18 5 2 6 1 20
20 1 6 2 20 12 20 2 6 1 20
20 20 6 20 5 5 20 6 1 20 0
0 20 1 20 2 18 2 20 1 20 0
0 20 20 6 18 18 6 20 20 0 0
0 0 20 1 18 11 18 1 20 0 0
0 0 20 1 6 6 1 20 0 0 0
0 0 20 3 1 6 1 3 20 0 0
0 20 3 20 1 1 20 3 20 0 0
0 20 3 20 4 1 4 20 3 20 0
20 20 2 2 4 4 2 2 2 20 0
20 3 18 20 18 4 18 20 18 3 20
3 18 1 20 18 18 20 1 18 3 0
3 5 5 5 20 13 20 5 5 5 3
3 18 3 20 18 18 20 3 18 3 0
0 3 18 20 1 1 1 20 18 3 0
5 3 20 20 20 20 20 20 3 5 0
5 1 1 1 3 11 3 1 1 1 5
3 5 5 5 3 3 5 5 5 3 0
20 20 20 20 5 3 5 20 20 20 20
0 1 0 20 18 18 20 0 1 0 0
0 1 0 0 20 5 20 0 0 1 0
20 20 20 20 1 1 20 20 20 20 0
0 0 0 0 0 0 0 0 0 0 0
0 0 0 0 0 0 0 0 0 0 0
0 0 0 0 0 0 0 0 0 0 0
0 0 0 0 0 0 0 0 0 0 0
0 0 0 0 0 0 0 0 0 0 0
0 0 0 0 0 0 0 0 0 0 0
0 0 0 0 0 0 0 0 0 0 0
0 0 0 0 0 0 0 0 0 0 0
0 0 0 0 0 0 0 0 0 0 0
0 0 0 0 0 0 0 0 0 0 0
0 0 0 0 0 0 0 0 0 0 0
0 0 0 0 0 0 0 0 0 0 0
0 0 0 0 0 0 0 0 0 0 0
0 0 0 0 0 0 0 0 0 0 0
0 0 0 0 0 0 0 0 0 0 0
0 0 0 0 0 0 0 0 0 0 0
0 0 0 0 0 0 0 0 0 0 0
0 0 0 0 0 0 0 0 0 0 0
0 0 0 0 0 0 0 0 0 0 0
0 0 0 0 0 0 0 0 0 0 0
0 0 0 0 0 0 0 0 0 0 0
0 0 0 0 0 0 0 0 0 0 0
0 0 0 0 0 0 0 0 0 0 0
0 0 0 0 0 0 0 0 0 0 0
0 0 0 0 0 0 0 0 0 0 0
0 0 0 0 0 0 0 0 0 0 0
0 0 0 0 0 0 0 0 0 0 0
0 0 0 0 0 0 0 0 0 0 0
0 0 0 0 0 0 0 0 0 0 0
0 0 0 0 0 0 0 0 0 0 0
0 0 0 0 0 0 0 0 0 0 0
0 0 0 0 0 0 0 0 0 0 0
0 0 0 0 0 0 0 0 0 0 0
0 0 0 0 0 0 0 0 0 0 0
0 0 0 0 0 0 0 0 0 0 0
0 0 0 0 0 0 0 0 0 0 0