MODE 2
SIZE 11/70
LIMIT 0/58
COLOR LIMIT 4
STARS 1300/4100/8200
POWERUPS 0/1/0/0
17 17 17 17 17 17 17 17 17 17 17
0 17 1 1 1 3 3 3 17 0 0
0 17 1 18 20 3 18 11 3 17 0
17 17 20 20 3 1 20 20 17 17 0
0 0 1 18 12 1 20 18 3 0 0
0 0 1 1 1 3 3 3 0 0 0
0 20 20 20 20 20 20 20 20 20 0
20 20 18 18 20 20 18 18 20 20 0
20 3 20 14 20 2 20 15 20 3 20
0 3 20 20 2 2 20 20 3 0 0
0 0 3 20 2 10 2 20 3 0 0
18 18 3 1 1 1 1 3 18 18 0
3 3 3 2 20 17 20 2 3 3 3
20 20 2 2 1 1 2 2 20 20 0
1 1 18 1 1 20 1 1 18 1 1
0 0 3 0 20 20 0 3 0 0 0
20 20 3 3 20 6 20 3 3 20 20
0 1 4 3 6 6 3 4 1 0 0
3 3 0 4 3 11 3 4 0 3 3
0 0 5 5 6 6 5 5 0 0 0
4 4 4 3 5 6 5 3 4 4 4
3 3 3 18 5 5 18 3 3 3 0
1 20 18 18 18 8 18 18 18 20 1
1 20 1 1 2 2 1 1 20 1 0
0 1 20 20 2 17 2 20 20 1 0
0 20 17 17 17 1 1 1 20 0 0
0 1 4 4 2 1 2 4 4 1 0
1 3 3 4 2 2 4 3 3 1 0
1 3 0 0 4 2 4 0 0 3 1
3 0 0 0 0 0 0 0 0 3 0
0 0 0 0 0 0 0 0 0 0 0
0 0 0 0 0 0 0 0 0 0 0
0 0 0 0 0 0 0 0 0 0 0
0 0 0 0 0 0 0 0 0 0 0
0 0 0 0 0 0 0 0 0 0 0
0 0 0 0 0 0 0 0 0 0 0
0 0 0 0 0 0 0 0 0 0 0
0 0 0 0 0 0 0 0 0 0 0
0 0 0 0 0 0 0 0 0 0 0
0 0 0 0 0 0 0 0 0 0 0
0 0 0 0 0 0 0 0 0 0 0
0 0 0 0 0 0 0 0 0 0 0
0 0 0 0 0 0 0 0 0 0 0
0 0 0 0 0 0 0 0 0 0 0
0 0 0 0 0 0 0 0 0 0 0
0 0 0 0 0 0 0 0 0 0 0
0 0 0 0 0 0 0 0 0 0 0
0 0 0 0 0 0 0 0 0 0 0
0 0 0 0 0 0 0 0 0 0 0
0 0 0 0 0 0 0 0 0 0 0
0 0 0 0 0 0 0 0 0 0 0
0 0 0 0 0 0 0 0 0 0 0
0 0 0 0 0 0 0 0 0 0 0
0 0 0 0 0 0 0 0 0 0 0
0 0 0 0 0 0 0 0 0 0 0
0 0 0 0 0 0 0 0 0 0 0
0 0 0 0 0 0 0 0 0 0 0
0 0 0 0 0 0 0 0 0 0 0
0 0 0 0 0 0 0 0 0 0 0
0 0 0 0 0 0 0 0 0 0 0
0 0 0 0 0 0 0 0 0 0 0
0 0 0 0 0 0 0 0 0 0 0
0 0 0 0 0 0 0 0 0 0 0
0 0 0 0 0 0 0 0 0 0 0
0 0 0 0 0 0 0 0 0 0 0
0 0 0 0 0 0 0 0 0 0 0
0 0 0 0 0 0 0 0 0 0 0
0 0 0 0 0 0 0 0 0 0 0
0 0 0 0 0 0 0 0 0 0 0
0 0 0 0 0 0 0 0 0 0 0