MODE 2
SIZE 11/70
LIMIT 0/60
COLOR LIMIT 4
STARS 1700/4950/9200
POWERUPS 1/1/0/0
0 0 17 17 17 2 17 17 17 0 0
0 17 1 1 2 5 3 3 17 0 0
0 17 1 13 1 5 3 11 3 17 0
17 17 17 1 5 2 3 17 17 17 0
0 18 18 18 18 5 2 18 18 18 0
1 1 1 5 20 5 2 1 1 1 0
0 0 1 5 2 20 2 6 1 0 0
0 1 4 5 5 5 16 4 1 0 0
4 4 4 17 1 1 1 17 4 4 4
0 0 1 17 3 3 17 1 0 0 0
1 1 1 17 3 18 3 17 1 1 1
0 0 0 20 18 18 20 0 0 0 0
0 0 0 0 3 14 3 0 0 0 0
20 20 20 20 3 3 20 20 20 20 0
1 18 1 1 20 3 20 3 3 18 3
18 3 3 20 18 18 20 1 1 18 1
20 20 20 20 18 13 18 20 20 20 20
2 1 3 5 18 18 5 3 1 2 0
0 2 1 3 20 5 20 3 1 2 0
0 2 1 20 3 3 20 1 2 0 0
0 0 2 20 1 1 1 20 2 0 0
0 0 20 2 2 2 2 20 0 0 0
7 7 7 7 20 20 20 7 7 7 7
7 7 7 20 18 18 20 7 7 7 0
7 7 20 7 20 11 20 7 20 7 7
7 7 20 7 20 20 7 20 7 7 0
0 7 7 7 7 20 7 7 7 7 0
7 7 7 7 0 0 7 7 7 7 0
0 3 3 0 0 0 0 0 3 3 0
0 3 3 0 0 0 0 3 3 0 0
20 20 20 20 0 0 0 20 20 20 20
0 0 0 0 0 0 0 0 0 0 0
0 0 0 0 0 0 0 0 0 0 0
0 0 0 0 0 0 0 0 0 0 0
0 0 0 0 0 0 0 0 0 0 0
0 0 0 0 0 0 0 0 0 0 0
0 0 0 0 0 0 0 0 0 0 0
0 0 0 0 0 0 0 0 0 0 0
0 0 0 0 0 0 0 0 0 0 0
0 0 0 0 0 0 0 0 0 0 0
0 0 0 0 0 0 0 0 0 0 0
0 0 0 0 0 0 0 0 0 0 0
0 0 0 0 0 0 0 0 0 0 0
0 0 0 0 0 0 0 0 0 0 0
0 0 0 0 0 0 0 0 0 0 0
0 0 0 0 0 0 0 0 0 0 0
0 0 0 0 0 0 0 0 0 0 0
0 0 0 0 0 0 0 0 0 0 0
0 0 0 0 0 0 0 0 0 0 0
0 0 0 0 0 0 0 0 0 0 0
0 0 0 0 0 0 0 0 0 0 0
0 0 0 0 0 0 0 0 0 0 0
0 0 0 0 0 0 0 0 0 0 0
0 0 0 0 0 0 0 0 0 0 0
0 0 0 0 0 0 0 0 0 0 0
0 0 0 0 0 0 0 0 0 0 0
0 0 0 0 0 0 0 0 0 0 0
0 0 0 0 0 0 0 0 0 0 0
0 0 0 0 0 0 0 0 0 0 0
0 0 0 0 0 0 0 0 0 0 0
0 0 0 0 0 0 0 0 0 0 0
0 0 0 0 0 0 0 0 0 0 0
0 0 0 0 0 0 0 0 0 0 0
0 0 0 0 0 0 0 0 0 0 0
0 0 0 0 0 0 0 0 0 0 0
0 0 0 0 0 0 0 0 0 0 0
0 0 0 0 0 0 0 0 0 0 0
0 0 0 0 0 0 0 0 0 0 0
0 0 0 0 0 0 0 0 0 0 0
0 0 0 0 0 0 0 0 0 0 0