MODE 2
SIZE 11/70
LIMIT 0/35
COLOR LIMIT 4
STARS 1700/4200/8700
POWERUPS 1/1/0/0
17 0 0 0 0 1 0 0 0 0 17
17 0 0 0 1 1 0 0 0 17 0
0 17 17 0 1 13 1 0 17 17 0
0 0 17 3 2 2 3 17 0 0 0
0 0 3 17 3 2 3 17 3 0 0
0 5 3 3 2 2 3 3 5 0 0
5 5 20 1 1 1 1 1 20 5 5
0 1 4 4 4 4 4 4 1 0 0
1 1 0 4 20 11 20 4 0 1 1
3 3 3 3 20 20 3 3 3 3 0
0 3 2 2 4 20 4 2 2 3 0
17 20 2 2 4 4 2 2 20 17 0
0 0 3 2 1 4 1 2 3 0 0
0 0 3 2 1 1 2 3 0 0 0
3 3 20 3 1 14 1 3 20 3 3
5 5 5 5 1 1 5 5 5 5 0
0 1 6 5 3 16 3 5 6 1 0
1 6 5 6 3 3 6 5 6 1 0
3 1 6 6 1 3 1 6 6 1 3
3 18 1 1 18 18 1 1 18 3 0
0 3 3 4 2 18 2 4 3 3 0
4 4 4 20 2 2 20 4 4 4 0
0 4 5 5 5 20 5 5 5 4 0
0 4 0 0 0 0 0 0 4 0 0
0 0 0 0 0 0 0 0 0 0 0
0 0 0 0 0 0 0 0 0 0 0
0 0 0 0 0 0 0 0 0 0 0
0 0 0 0 0 0 0 0 0 0 0
0 0 0 0 0 0 0 0 0 0 0
0 0 0 0 0 0 0 0 0 0 0
0 0 0 0 0 0 0 0 0 0 0
0 0 0 0 0 0 0 0 0 0 0
0 0 0 0 0 0 0 0 0 0 0
0 0 0 0 0 0 0 0 0 0 0
0 0 0 0 0 0 0 0 0 0 0
0 0 0 0 0 0 0 0 0 0 0
0 0 0 0 0 0 0 0 0 0 0
0 0 0 0 0 0 0 0 0 0 0
0 0 0 0 0 0 0 0 0 0 0
0 0 0 0 0 0 0 0 0 0 0
0 0 0 0 0 0 0 0 0 0 0
0 0 0 0 0 0 0 0 0 0 0
0 0 0 0 0 0 0 0 0 0 0
0 0 0 0 0 0 0 0 0 0 0
0 0 0 0 0 0 0 0 0 0 0
0 0 0 0 0 0 0 0 0 0 0
0 0 0 0 0 0 0 0 0 0 0
0 0 0 0 0 0 0 0 0 0 0
0 0 0 0 0 0 0 0 0 0 0
0 0 0 0 0 0 0 0 0 0 0
0 0 0 0 0 0 0 0 0 0 0
0 0 0 0 0 0 0 0 0 0 0
0 0 0 0 0 0 0 0 0 0 0
0 0 0 0 0 0 0 0 0 0 0
0 0 0 0 0 0 0 0 0 0 0
0 0 0 0 0 0 0 0 0 0 0
0 0 0 0 0 0 0 0 0 0 0
0 0 0 0 0 0 0 0 0 0 0
0 0 0 0 0 0 0 0 0 0 0
0 0 0 0 0 0 0 0 0 0 0
0 0 0 0 0 0 0 0 0 0 0
0 0 0 0 0 0 0 0 0 0 0
0 0 0 0 0 0 0 0 0 0 0
0 0 0 0 0 0 0 0 0 0 0
0 0 0 0 0 0 0 0 0 0 0
0 0 0 0 0 0 0 0 0 0 0
0 0 0 0 0 0 0 0 0 0 0
0 0 0 0 0 0 0 0 0 0 0
0 0 0 0 0 0 0 0 0 0 0
0 0 0 0 0 0 0 0 0 0 0