MODE 2
SIZE 11/70
LIMIT 0/30
COLOR LIMIT 4
STARS 1200/3400/5700
POWERUPS 0/0/0/0
1 1 1 1 0 17 0 1 1 1 1
0 0 1 20 20 20 20 1 0 0 0
0 0 1 0 0 12 0 0 1 0 0
17 3 3 3 1 3 3 3 3 17 0
0 1 3 0 1 2 1 0 3 1 0
1 20 3 1 2 2 1 3 20 1 0
1 0 20 3 2 11 2 1 20 0 1
0 20 1 3 2 2 3 1 20 0 0
0 20 1 1 1 1 1 1 1 20 0
20 20 20 20 3 3 20 20 20 20 0
0 0 0 0 20 3 20 0 0 0 0
7 7 7 7 7 7 7 7 7 7 0
20 20 7 7 18 18 18 7 7 20 20
0 20 7 18 7 7 18 7 20 0 0
0 0 20 7 18 13 18 7 20 0 0
0 0 20 7 18 18 7 20 0 0 0
20 20 20 20 7 18 7 20 20 20 20
0 0 20 7 18 18 7 20 0 0 0
0 0 20 7 18 12 18 7 20 0 0
0 20 7 18 7 7 18 7 20 0 0
20 20 7 7 18 18 18 7 7 20 20
7 7 7 7 7 7 7 7 7 7 0
0 0 0 0 0 0 0 0 0 0 0
0 0 0 0 0 0 0 0 0 0 0
0 0 0 0 0 0 0 0 0 0 0
0 0 0 0 0 0 0 0 0 0 0
0 0 0 0 0 0 0 0 0 0 0
0 0 0 0 0 0 0 0 0 0 0
0 0 0 0 0 0 0 0 0 0 0
0 0 0 0 0 0 0 0 0 0 0
0 0 0 0 0 0 0 0 0 0 0
0 0 0 0 0 0 0 0 0 0 0
0 0 0 0 0 0 0 0 0 0 0
0 0 0 0 0 0 0 0 0 0 0
0 0 0 0 0 0 0 0 0 0 0
0 0 0 0 0 0 0 0 0 0 0
0 0 0 0 0 0 0 0 0 0 0
0 0 0 0 0 0 0 0 0 0 0
0 0 0 0 0 0 0 0 0 0 0
0 0 0 0 0 0 0 0 0 0 0
0 0 0 0 0 0 0 0 0 0 0
0 0 0 0 0 0 0 0 0 0 0
0 0 0 0 0 0 0 0 0 0 0
0 0 0 0 0 0 0 0 0 0 0
0 0 0 0 0 0 0 0 0 0 0
0 0 0 0 0 0 0 0 0 0 0
0 0 0 0 0 0 0 0 0 0 0
0 0 0 0 0 0 0 0 0 0 0
0 0 0 0 0 0 0 0 0 0 0
0 0 0 0 0 0 0 0 0 0 0
0 0 0 0 0 0 0 0 0 0 0
0 0 0 0 0 0 0 0 0 0 0
0 0 0 0 0 0 0 0 0 0 0
0 0 0 0 0 0 0 0 0 0 0
0 0 0 0 0 0 0 0 0 0 0
0 0 0 0 0 0 0 0 0 0 0
0 0 0 0 0 0 0 0 0 0 0
0 0 0 0 0 0 0 0 0 0 0
0 0 0 0 0 0 0 0 0 0 0
0 0 0 0 0 0 0 0 0 0 0
0 0 0 0 0 0 0 0 0 0 0
0 0 0 0 0 0 0 0 0 0 0
0 0 0 0 0 0 0 0 0 0 0
0 0 0 0 0 0 0 0 0 0 0
0 0 0 0 0 0 0 0 0 0 0
0 0 0 0 0 0 0 0 0 0 0
0 0 0 0 0 0 0 0 0 0 0
0 0 0 0 0 0 0 0 0 0 0
0 0 0 0 0 0 0 0 0 0 0
0 0 0 0 0 0 0 0 0 0 0