MODE 2
SIZE 11/70
LIMIT 0/50
COLOR LIMIT 4
STARS 2600/5900/8700
POWERUPS 1/1/1/0
17 17 17 0 0 0 0 0 17 17 17
0 0 17 20 20 20 20 17 0 0 0
20 20 20 17 3 1 3 17 20 20 20
0 1 17 5 5 5 5 17 3 0 0
0 1 13 1 18 18 18 3 11 3 0
0 1 1 18 5 18 18 3 3 0 0
20 20 20 18 5 13 5 18 20 20 20
0 0 20 18 5 5 18 20 0 0 0
7 7 7 7 18 5 18 7 7 7 7
7 7 7 1 18 18 1 7 7 7 7
7 7 7 3 1 18 1 3 7 7 7
7 7 20 3 1 1 3 20 7 7 7
7 7 14 20 3 1 3 20 12 7 7
7 7 7 7 7 7 7 7 7 7 7
7 7 7 7 7 7 7 7 7 7 7
7 7 20 20 20 20 20 20 7 7 0
0 7 7 20 3 3 3 20 7 7 0
0 7 7 20 3 3 20 7 7 0 0
0 0 7 7 20 3 20 7 7 0 0
20 20 7 7 20 20 7 7 20 20 0
0 0 7 7 20 1 20 7 7 0 0
0 7 7 20 1 1 20 7 7 0 0
0 7 7 20 1 1 1 20 7 7 0
7 7 20 20 20 20 20 20 7 7 0
0 0 18 2 3 2 2 2 18 0 0
0 18 4 2 3 3 2 4 18 0 0
0 0 18 20 2 3 3 20 18 0 0
0 0 20 4 2 2 4 20 0 0 0
0 0 20 4 4 2 4 4 20 0 0
0 20 4 4 18 18 4 4 20 0 0
3 20 3 3 1 1 1 3 3 20 3
2 20 2 6 1 1 6 2 20 2 0
1 1 20 6 18 1 18 6 20 1 1
6 6 6 18 20 20 18 6 6 6 0
0 0 18 18 0 0 0 18 18 0 0
0 0 0 0 0 0 0 0 0 0 0
0 0 0 0 0 0 0 0 0 0 0
0 0 0 0 0 0 0 0 0 0 0
0 0 0 0 0 0 0 0 0 0 0
0 0 0 0 0 0 0 0 0 0 0
0 0 0 0 0 0 0 0 0 0 0
0 0 0 0 0 0 0 0 0 0 0
0 0 0 0 0 0 0 0 0 0 0
0 0 0 0 0 0 0 0 0 0 0
0 0 0 0 0 0 0 0 0 0 0
0 0 0 0 0 0 0 0 0 0 0
0 0 0 0 0 0 0 0 0 0 0
0 0 0 0 0 0 0 0 0 0 0
0 0 0 0 0 0 0 0 0 0 0
0 0 0 0 0 0 0 0 0 0 0
0 0 0 0 0 0 0 0 0 0 0
0 0 0 0 0 0 0 0 0 0 0
0 0 0 0 0 0 0 0 0 0 0
0 0 0 0 0 0 0 0 0 0 0
0 0 0 0 0 0 0 0 0 0 0
0 0 0 0 0 0 0 0 0 0 0
0 0 0 0 0 0 0 0 0 0 0
0 0 0 0 0 0 0 0 0 0 0
0 0 0 0 0 0 0 0 0 0 0
0 0 0 0 0 0 0 0 0 0 0
0 0 0 0 0 0 0 0 0 0 0
0 0 0 0 0 0 0 0 0 0 0
0 0 0 0 0 0 0 0 0 0 0
0 0 0 0 0 0 0 0 0 0 0
0 0 0 0 0 0 0 0 0 0 0
0 0 0 0 0 0 0 0 0 0 0
0 0 0 0 0 0 0 0 0 0 0
0 0 0 0 0 0 0 0 0 0 0
0 0 0 0 0 0 0 0 0 0 0
0 0 0 0 0 0 0 0 0 0 0