MODE 2
SIZE 11/70
LIMIT 0/37
COLOR LIMIT 4
STARS 2600/5000/8600
POWERUPS 0/1/0/0
0 0 0 0 17 17 17 0 0 0 0
1 1 1 17 18 18 17 1 1 1 0
1 2 3 2 1 12 1 2 3 2 1
2 3 3 2 1 1 2 3 3 2 0
2 3 11 3 2 17 2 3 11 3 2
2 3 2 2 1 1 2 2 3 2 0
1 2 3 2 1 13 1 2 3 2 1
1 1 1 17 18 18 17 1 1 1 4
4 5 5 5 1 18 1 5 5 5 4
4 5 5 3 1 1 3 5 5 4 0
0 4 5 17 3 1 3 17 5 4 0
0 4 3 6 3 3 6 3 4 0 0
4 4 3 6 6 14 6 6 3 4 4
1 17 1 1 18 18 1 1 17 1 0
4 4 3 6 6 3 6 6 3 4 4
4 5 3 6 3 3 6 3 5 4 0
4 5 2 3 3 4 3 3 2 5 4
5 2 4 3 4 4 3 4 2 5 4
5 2 0 4 5 16 5 4 0 2 5
0 0 0 0 5 5 0 0 0 0 0
0 0 0 0 0 5 0 0 0 0 0
0 0 0 0 5 5 0 0 0 0 0
0 0 0 0 0 0 0 0 0 0 0
0 0 0 0 0 0 0 0 0 0 0
0 0 0 0 0 0 0 0 0 0 0
0 0 0 0 0 0 0 0 0 0 0
0 0 0 0 0 0 0 0 0 0 0
0 0 0 0 0 0 0 0 0 0 0
0 0 0 0 0 0 0 0 0 0 0
0 0 0 0 0 0 0 0 0 0 0
0 0 0 0 0 0 0 0 0 0 0
0 0 0 0 0 0 0 0 0 0 0
0 0 0 0 0 0 0 0 0 0 0
0 0 0 0 0 0 0 0 0 0 0
0 0 0 0 0 0 0 0 0 0 0
0 0 0 0 0 0 0 0 0 0 0
0 0 0 0 0 0 0 0 0 0 0
0 0 0 0 0 0 0 0 0 0 0
0 0 0 0 0 0 0 0 0 0 0
0 0 0 0 0 0 0 0 0 0 0
0 0 0 0 0 0 0 0 0 0 0
0 0 0 0 0 0 0 0 0 0 0
0 0 0 0 0 0 0 0 0 0 0
0 0 0 0 0 0 0 0 0 0 0
0 0 0 0 0 0 0 0 0 0 0
0 0 0 0 0 0 0 0 0 0 0
0 0 0 0 0 0 0 0 0 0 0
0 0 0 0 0 0 0 0 0 0 0
0 0 0 0 0 0 0 0 0 0 0
0 0 0 0 0 0 0 0 0 0 0
0 0 0 0 0 0 0 0 0 0 0
0 0 0 0 0 0 0 0 0 0 0
0 0 0 0 0 0 0 0 0 0 0
0 0 0 0 0 0 0 0 0 0 0
0 0 0 0 0 0 0 0 0 0 0
0 0 0 0 0 0 0 0 0 0 0
0 0 0 0 0 0 0 0 0 0 0
0 0 0 0 0 0 0 0 0 0 0
0 0 0 0 0 0 0 0 0 0 0
0 0 0 0 0 0 0 0 0 0 0
0 0 0 0 0 0 0 0 0 0 0
0 0 0 0 0 0 0 0 0 0 0
0 0 0 0 0 0 0 0 0 0 0
0 0 0 0 0 0 0 0 0 0 0
0 0 0 0 0 0 0 0 0 0 0
0 0 0 0 0 0 0 0 0 0 0
0 0 0 0 0 0 0 0 0 0 0
0 0 0 0 0 0 0 0 0 0 0
0 0 0 0 0 0 0 0 0 0 0
0 0 0 0 0 0 0 0 0 0 0