MODE 2
SIZE 11/70
LIMIT 0/55
COLOR LIMIT 4
STARS 2600/5900/9700
POWERUPS 1/1/0/0
7 7 7 7 7 17 7 7 7 7 7
17 20 14 20 3 5 20 14 20 17 0
20 20 20 20 20 20 20 20 20 20 20
17 20 15 20 5 3 20 16 20 17 0
1 1 18 1 1 11 3 1 18 1 1
17 0 0 5 1 1 3 0 0 17 0
20 20 20 20 20 20 20 20 20 20 20
17 0 5 0 1 1 0 3 0 17 0
3 3 18 3 3 17 1 3 18 3 3
17 0 0 1 3 3 1 0 0 17 0
20 20 20 20 20 20 20 20 20 20 20
17 15 1 0 3 3 0 1 15 17 0
2 2 2 5 5 13 3 5 2 2 2
17 0 0 3 5 5 3 0 0 17 0
20 20 20 20 20 20 20 20 20 20 20
17 0 3 0 5 5 0 3 0 17 0
4 4 4 3 3 17 5 3 4 4 4
17 0 0 5 3 3 5 0 0 17 0
20 20 20 20 20 20 20 20 20 20 20
17 0 5 0 18 18 0 5 0 17 0
6 6 6 3 3 12 3 3 6 6 6
0 0 0 0 18 18 0 0 0 0 0
0 0 0 0 0 0 0 0 0 0 0
0 0 0 0 0 0 0 0 0 0 0
0 0 0 0 0 0 0 0 0 0 0
0 0 0 0 0 0 0 0 0 0 0
0 0 0 0 0 0 0 0 0 0 0
0 0 0 0 0 0 0 0 0 0 0
0 0 0 0 0 0 0 0 0 0 0
0 0 0 0 0 0 0 0 0 0 0
0 0 0 0 0 0 0 0 0 0 0
0 0 0 0 0 0 0 0 0 0 0
0 0 0 0 0 0 0 0 0 0 0
0 0 0 0 0 0 0 0 0 0 0
0 0 0 0 0 0 0 0 0 0 0
0 0 0 0 0 0 0 0 0 0 0
0 0 0 0 0 0 0 0 0 0 0
0 0 0 0 0 0 0 0 0 0 0
0 0 0 0 0 0 0 0 0 0 0
0 0 0 0 0 0 0 0 0 0 0
0 0 0 0 0 0 0 0 0 0 0
0 0 0 0 0 0 0 0 0 0 0
0 0 0 0 0 0 0 0 0 0 0
0 0 0 0 0 0 0 0 0 0 0
0 0 0 0 0 0 0 0 0 0 0
0 0 0 0 0 0 0 0 0 0 0
0 0 0 0 0 0 0 0 0 0 0
0 0 0 0 0 0 0 0 0 0 0
0 0 0 0 0 0 0 0 0 0 0
0 0 0 0 0 0 0 0 0 0 0
0 0 0 0 0 0 0 0 0 0 0
0 0 0 0 0 0 0 0 0 0 0
0 0 0 0 0 0 0 0 0 0 0
0 0 0 0 0 0 0 0 0 0 0
0 0 0 0 0 0 0 0 0 0 0
0 0 0 0 0 0 0 0 0 0 0
0 0 0 0 0 0 0 0 0 0 0
0 0 0 0 0 0 0 0 0 0 0
0 0 0 0 0 0 0 0 0 0 0
0 0 0 0 0 0 0 0 0 0 0
0 0 0 0 0 0 0 0 0 0 0
0 0 0 0 0 0 0 0 0 0 0
0 0 0 0 0 0 0 0 0 0 0
0 0 0 0 0 0 0 0 0 0 0
0 0 0 0 0 0 0 0 0 0 0
0 0 0 0 0 0 0 0 0 0 0
0 0 0 0 0 0 0 0 0 0 0
0 0 0 0 0 0 0 0 0 0 0
0 0 0 0 0 0 0 0 0 0 0
0 0 0 0 0 0 0 0 0 0 0