MODE 2
SIZE 11/70
LIMIT 0/58
COLOR LIMIT 4
STARS 3900/7600/12500
POWERUPS 1/1/0/0
18 0 0 17 17 0 17 17 0 0 18
18 3 3 3 17 17 3 3 3 18 0
1 18 2 11 3 4 3 11 2 18 1
1 3 3 3 4 4 3 3 3 1 0
0 1 20 20 4 18 4 20 20 1 0
0 1 18 5 18 18 5 18 1 0 0
1 1 1 4 5 14 5 4 1 1 1
4 4 4 2 6 6 2 4 4 4 4
20 20 20 2 6 15 6 2 20 20 20
2 2 2 3 6 6 3 2 2 2 2
20 20 20 3 3 20 3 3 20 20 20
3 3 3 5 1 1 5 3 3 3 3
5 5 5 5 1 13 1 5 5 5 5
3 3 3 5 1 1 5 3 3 3 0
6 3 6 6 6 18 6 6 6 3 6
18 3 18 5 18 18 5 18 3 18 0
0 18 17 5 18 16 18 5 17 18 0
18 3 1 1 1 1 1 1 3 18 0
18 3 7 1 18 2 18 1 7 3 18
3 7 7 1 2 2 1 7 7 3 0
3 7 7 0 1 12 2 0 7 7 3
7 7 0 2 1 1 2 0 7 7 0
7 7 7 2 18 1 18 2 7 7 7
7 0 2 2 2 2 2 2 0 7 7
7 7 0 7 0 0 0 7 0 7 7
7 7 7 7 7 7 7 7 7 7 0
0 7 7 7 7 7 7 7 7 7 0
0 7 7 7 7 7 7 7 7 0 0
0 0 0 0 0 0 0 0 0 0 0
0 0 0 0 0 0 0 0 0 0 0
0 0 0 0 0 0 0 0 0 0 0
0 0 0 0 0 0 0 0 0 0 0
0 0 0 0 0 0 0 0 0 0 0
0 0 0 0 0 0 0 0 0 0 0
0 0 0 0 0 0 0 0 0 0 0
0 0 0 0 0 0 0 0 0 0 0
0 0 0 0 0 0 0 0 0 0 0
0 0 0 0 0 0 0 0 0 0 0
0 0 0 0 0 0 0 0 0 0 0
0 0 0 0 0 0 0 0 0 0 0
0 0 0 0 0 0 0 0 0 0 0
0 0 0 0 0 0 0 0 0 0 0
0 0 0 0 0 0 0 0 0 0 0
0 0 0 0 0 0 0 0 0 0 0
0 0 0 0 0 0 0 0 0 0 0
0 0 0 0 0 0 0 0 0 0 0
0 0 0 0 0 0 0 0 0 0 0
0 0 0 0 0 0 0 0 0 0 0
0 0 0 0 0 0 0 0 0 0 0
0 0 0 0 0 0 0 0 0 0 0
0 0 0 0 0 0 0 0 0 0 0
0 0 0 0 0 0 0 0 0 0 0
0 0 0 0 0 0 0 0 0 0 0
0 0 0 0 0 0 0 0 0 0 0
0 0 0 0 0 0 0 0 0 0 0
0 0 0 0 0 0 0 0 0 0 0
0 0 0 0 0 0 0 0 0 0 0
0 0 0 0 0 0 0 0 0 0 0
0 0 0 0 0 0 0 0 0 0 0
0 0 0 0 0 0 0 0 0 0 0
0 0 0 0 0 0 0 0 0 0 0
0 0 0 0 0 0 0 0 0 0 0
0 0 0 0 0 0 0 0 0 0 0
0 0 0 0 0 0 0 0 0 0 0
0 0 0 0 0 0 0 0 0 0 0
0 0 0 0 0 0 0 0 0 0 0
0 0 0 0 0 0 0 0 0 0 0
0 0 0 0 0 0 0 0 0 0 0
0 0 0 0 0 0 0 0 0 0 0
0 0 0 0 0 0 0 0 0 0 0