MODE 2
SIZE 11/70
LIMIT 0/80
COLOR LIMIT 4
STARS 4900/8200/1200
POWERUPS 1/1/1/0
17 17 17 7 20 13 20 7 17 17 17
7 7 20 20 7 7 20 20 7 7 7
7 7 7 20 7 20 7 20 7 7 7
7 7 7 7 20 20 7 7 7 7 7
7 7 8 7 20 7 20 7 8 7 7
7 7 7 20 7 7 20 7 7 7 7
7 7 7 20 7 11 7 20 7 7 7
7 20 7 20 7 7 20 7 20 7 7
7 7 20 7 20 7 20 7 20 7 7
7 7 20 7 20 20 7 20 7 7 7
7 7 7 20 7 20 7 20 7 7 7
20 20 20 20 7 7 20 20 20 20 7
7 7 7 7 7 14 7 7 7 7 7
7 7 18 7 7 7 7 18 7 7 7
7 7 18 7 7 9 7 7 18 7 7
7 7 7 7 18 18 7 7 7 7 7
10 18 7 7 7 12 7 7 7 18 7
18 7 7 7 18 18 7 7 7 18 7
7 7 7 7 7 7 7 7 7 7 7
8 7 18 7 7 7 7 18 7 8 7
7 7 18 7 7 7 7 7 18 7 7
20 7 7 7 18 18 7 7 7 20 7
7 20 7 7 18 15 18 7 7 20 7
7 20 20 20 18 7 20 20 20 7 7
7 7 7 17 20 7 20 17 7 7 7
7 7 17 7 7 7 7 17 7 7 7
7 7 17 7 7 10 7 7 17 7 7
20 20 20 20 7 7 20 20 20 20 7
7 7 7 7 20 16 20 7 7 7 7
18 18 7 7 20 20 7 7 18 18 7
7 7 7 7 7 20 7 7 7 7 7
7 18 18 7 7 7 7 18 18 7 7
7 7 7 7 18 18 18 7 7 7 7
7 7 7 0 7 7 7 0 7 7 7
0 7 7 0 0 7 7 0 0 7 7
0 7 0 0 0 7 0 0 0 7 0
0 0 0 0 0 0 0 0 0 0 0
0 0 0 0 0 0 0 0 0 0 0
0 0 0 0 0 0 0 0 0 0 0
0 0 0 0 0 0 0 0 0 0 0
0 0 0 0 0 0 0 0 0 0 0
0 0 0 0 0 0 0 0 0 0 0
0 0 0 0 0 0 0 0 0 0 0
0 0 0 0 0 0 0 0 0 0 0
0 0 0 0 0 0 0 0 0 0 0
0 0 0 0 0 0 0 0 0 0 0
0 0 0 0 0 0 0 0 0 0 0
0 0 0 0 0 0 0 0 0 0 0
0 0 0 0 0 0 0 0 0 0 0
0 0 0 0 0 0 0 0 0 0 0
0 0 0 0 0 0 0 0 0 0 0
0 0 0 0 0 0 0 0 0 0 0
0 0 0 0 0 0 0 0 0 0 0
0 0 0 0 0 0 0 0 0 0 0
0 0 0 0 0 0 0 0 0 0 0
0 0 0 0 0 0 0 0 0 0 0
0 0 0 0 0 0 0 0 0 0 0
0 0 0 0 0 0 0 0 0 0 0
0 0 0 0 0 0 0 0 0 0 0
0 0 0 0 0 0 0 0 0 0 0
0 0 0 0 0 0 0 0 0 0 0
0 0 0 0 0 0 0 0 0 0 0
0 0 0 0 0 0 0 0 0 0 0
0 0 0 0 0 0 0 0 0 0 0
0 0 0 0 0 0 0 0 0 0 0
0 0 0 0 0 0 0 0 0 0 0
0 0 0 0 0 0 0 0 0 0 0
0 0 0 0 0 0 0 0 0 0 0
0 0 0 0 0 0 0 0 0 0 0
0 0 0 0 0 0 0 0 0 0 0