MODE 2
SIZE 11/70
LIMIT 0/100
COLOR LIMIT 4
STARS 7600/11000/15000
POWERUPS 1/1/1/1
17 17 0 3 3 3 3 3 0 17 17
20 0 3 18 2 2 2 1 0 20 0
17 17 3 2 18 1 1 2 3 17 17
20 3 2 1 18 13 1 2 3 20 7
7 7 3 2 1 1 1 2 3 7 7
7 20 1 2 2 2 5 3 20 7 7
7 7 20 3 3 20 3 3 20 7 7
17 17 20 20 20 20 20 20 17 17 7
7 7 17 1 1 1 1 1 17 7 7
7 20 17 3 3 3 18 17 20 7 7
7 20 1 3 2 2 18 3 1 20 7
8 1 3 2 18 11 2 5 1 8 7
7 20 1 3 2 2 2 3 1 20 7
7 20 1 18 3 3 3 1 20 7 7
7 7 20 1 1 20 1 1 20 7 7
17 17 20 20 20 9 20 20 17 17 0
7 7 17 2 2 2 2 2 17 7 7
7 20 17 1 1 1 18 17 20 7 7
7 20 2 1 3 3 18 1 2 20 7
7 2 1 3 12 18 3 1 2 7 7
7 20 2 1 3 3 3 1 2 20 7
7 20 2 8 1 1 1 2 20 7 7
7 7 20 2 2 20 2 2 20 7 7
17 17 20 20 20 20 20 20 17 17 0
7 7 17 4 4 4 4 4 17 7 7
7 20 17 3 3 3 18 17 20 7 7
7 20 4 3 1 1 18 3 4 20 7
7 4 3 1 18 14 1 3 4 8 0
7 20 4 3 1 1 1 3 4 20 7
7 20 4 2 3 3 3 4 20 7 7
7 7 20 4 4 20 4 4 20 7 7
17 17 20 20 20 20 20 9 17 17 0
7 7 17 6 6 6 6 6 17 7 7
7 10 17 1 1 1 18 17 20 7 7
7 20 6 1 3 3 18 1 6 20 8
7 6 1 3 16 18 3 1 6 7 0
7 20 6 1 3 3 3 1 6 20 7
7 20 6 1 1 1 1 6 20 7 7
7 7 20 6 6 20 6 6 20 7 7
17 17 20 20 20 20 20 20 17 17 7
7 7 17 3 3 3 3 3 17 7 7
7 20 17 2 2 2 18 17 20 7 7
7 20 3 2 1 1 18 2 3 20 7
7 3 2 1 18 13 1 2 7 7 7
7 20 3 2 1 1 1 2 3 20 7
7 20 3 2 2 2 2 3 20 7 7
7 7 20 3 3 8 3 3 20 7 7
7 7 20 20 20 20 20 20 7 7 7
7 7 7 7 7 7 7 7 7 7 7
7 0 17 7 7 0 17 7 7 0 17
7 0 17 0 7 0 17 0 7 0 17
7 0 0 7 7 0 0 7 7 0 0
7 7 7 7 7 7 7 7 7 7 7
20 0 20 0 20 0 20 0 20 0 20
0 0 0 0 0 0 0 0 0 0 0
0 0 0 0 0 0 0 0 0 0 0
0 0 0 0 0 0 0 0 0 0 0
0 0 0 0 0 0 0 0 0 0 0
0 0 0 0 0 0 0 0 0 0 0
0 0 0 0 0 0 0 0 0 0 0
0 0 0 0 0 0 0 0 0 0 0
0 0 0 0 0 0 0 0 0 0 0
0 0 0 0 0 0 0 0 0 0 0
0 0 0 0 0 0 0 0 0 0 0
0 0 0 0 0 0 0 0 0 0 0
0 0 0 0 0 0 0 0 0 0 0
0 0 0 0 0 0 0 0 0 0 0
0 0 0 0 0 0 0 0 0 0 0
0 0 0 0 0 0 0 0 0 0 0
0 0 0 0 0 0 0 0 0 0 0