MODE 2
SIZE 11/70
LIMIT 0/20
COLOR LIMIT 4
STARS 1000/1500/3500
POWERUPS 1/1/0/0
7 7 7 0 0 0 0 0 0 0 0
7 11 7 0 0 0 0 0 0 0 0
7 7 7 0 0 0 0 0 0 0 0
7 7 7 0 0 0 0 0 0 0 0
7 9 7 0 0 0 0 0 0 0 0
7 7 7 0 0 0 0 0 0 0 0
7 7 7 0 0 0 0 0 0 0 0
7 12 7 0 0 0 0 0 0 0 0
7 7 7 0 0 0 0 0 0 0 0
7 7 7 0 0 0 0 0 0 0 0
7 7 7 0 0 0 0 0 0 0 0
7 7 7 7 7 7 7 7 7 7 7
8 7 7 7 12 7 7 7 7 7 7
7 7 7 7 7 7 7 7 7 7 7
0 0 0 0 0 0 0 0 7 7 7
0 0 0 0 0 0 0 0 7 11 7
0 0 0 0 0 0 0 0 7 7 7
0 0 0 0 0 0 0 0 7 7 7
0 0 0 0 0 0 0 0 7 13 7
0 0 0 0 0 0 0 0 7 7 7
0 0 0 0 0 0 0 0 7 7 7
0 0 0 0 0 0 0 0 7 7 7
0 0 0 0 0 0 0 0 7 7 7
0 0 0 0 0 0 0 0 7 7 7
0 0 0 0 0 0 0 0 7 7 7
0 0 0 0 0 0 0 0 7 13 7
0 0 0 0 0 0 0 0 7 7 7
0 0 0 0 0 0 0 0 7 7 7
0 0 0 0 0 0 0 0 7 7 7
7 7 7 7 7 7 7 7 7 7 7
7 13 7 7 7 7 7 7 11 7 7
7 7 7 7 7 7 7 7 7 7 7
7 7 7 0 0 0 0 0 0 0 0
7 7 7 0 0 0 0 0 0 0 0
7 7 7 0 0 0 0 0 0 0 0
7 12 7 0 0 0 0 0 0 0 0
7 7 7 0 0 0 0 0 0 0 0
7 7 7 0 0 0 0 0 0 0 0
7 7 7 0 0 0 0 0 0 0 0
7 7 7 0 0 0 0 0 0 0 0
7 7 7 0 0 0 0 0 0 0 0
7 12 7 0 0 0 0 0 0 0 0
7 7 7 0 0 0 0 0 0 0 0
7 7 7 0 0 0 0 0 0 0 0
7 7 7 0 0 0 0 0 0 0 0
7 7 7 0 0 0 0 0 0 0 0
7 7 7 0 0 0 0 0 0 0 0
7 7 7 0 0 0 0 0 0 0 0
0 0 0 0 0 0 0 0 0 0 0
0 0 0 0 0 0 0 0 0 0 0
0 0 0 0 0 0 0 0 0 0 0
0 0 0 0 0 0 0 0 0 0 0
0 0 0 0 0 0 0 0 0 0 0
0 0 0 0 0 0 0 0 0 0 0
0 0 0 0 0 0 0 0 0 0 0
0 0 0 0 0 0 0 0 0 0 0
0 0 0 0 0 0 0 0 0 0 0
0 0 0 0 0 0 0 0 0 0 0
0 0 0 0 0 0 0 0 0 0 0
0 0 0 0 0 0 0 0 0 0 0
0 0 0 0 0 0 0 0 0 0 0
0 0 0 0 0 0 0 0 0 0 0
0 0 0 0 0 0 0 0 0 0 0
0 0 0 0 0 0 0 0 0 0 0
0 0 0 0 0 0 0 0 0 0 0
0 0 0 0 0 0 0 0 0 0 0
0 0 0 0 0 0 0 0 0 0 0
0 0 0 0 0 0 0 0 0 0 0
0 0 0 0 0 0 0 0 0 0 0
0 0 0 0 0 0 0 0 0 0 0