MODE 2
SIZE 11/70
LIMIT 0/18
COLOR LIMIT 4
STARS 1000/1500/2000
POWERUPS 0/1/1/0
7 11 0 0 0 0 0 0 0 0 0
0 7 7 0 0 0 0 0 0 0 0
0 0 0 7 7 0 0 0 0 0 0
0 0 0 0 7 7 0 0 0 0 0
0 0 0 0 0 0 7 7 0 0 0
0 0 0 0 0 0 0 7 7 0 0
0 0 0 0 0 0 0 0 0 7 7
0 0 0 0 0 0 0 0 0 7 11
0 0 0 0 0 0 0 0 7 7 0
0 0 0 0 0 0 7 7 0 0 0
0 0 0 0 0 7 7 0 0 0 0
0 0 0 7 7 0 0 0 0 0 0
0 0 7 7 0 0 0 0 0 0 0
12 7 0 0 0 0 0 0 0 0 0
0 0 7 7 0 0 0 0 0 0 0
0 0 0 7 7 0 0 0 0 0 0
0 0 0 0 0 7 7 0 0 0 0
0 0 0 0 0 0 7 7 0 0 0
0 0 0 0 0 0 0 0 7 7 0
0 0 0 0 0 0 0 0 0 7 11
0 0 0 0 0 0 0 0 7 7 0
0 0 0 0 0 0 7 7 0 0 0
0 0 0 0 0 7 7 0 0 0 0
0 0 0 7 7 0 0 0 0 0 0
0 0 7 7 0 0 0 0 0 0 0
13 7 0 0 0 0 0 0 0 0 0
0 0 7 7 0 0 0 0 0 0 0
0 0 0 7 7 0 0 0 0 0 0
0 0 0 0 0 7 7 0 0 0 0
0 0 0 0 0 0 7 7 0 0 0
0 0 0 0 0 0 0 0 7 7 0
0 0 0 0 0 0 0 0 0 7 12
20 20 20 20 20 20 20 20 20 20 20
13 20 20 20 20 20 20 20 20 20 12
20 20 20 20 20 20 20 20 20 20 20
7 7 7 7 7 7 7 7 7 7 7
7 7 7 7 7 7 7 7 7 7 7
7 7 7 7 7 7 7 7 7 7 7
0 0 0 0 0 0 0 0 0 0 0
0 0 0 0 0 0 0 0 0 0 0
0 0 0 0 0 0 0 0 0 0 0
0 0 0 0 0 0 0 0 0 0 0
0 0 0 0 0 0 0 0 0 0 0
0 0 0 0 0 0 0 0 0 0 0
0 0 0 0 0 0 0 0 0 0 0
0 0 0 0 0 0 0 0 0 0 0
0 0 0 0 0 0 0 0 0 0 0
0 0 0 0 0 0 0 0 0 0 0
0 0 0 0 0 0 0 0 0 0 0
0 0 0 0 0 0 0 0 0 0 0
0 0 0 0 0 0 0 0 0 0 0
0 0 0 0 0 0 0 0 0 0 0
0 0 0 0 0 0 0 0 0 0 0
0 0 0 0 0 0 0 0 0 0 0
0 0 0 0 0 0 0 0 0 0 0
0 0 0 0 0 0 0 0 0 0 0
0 0 0 0 0 0 0 0 0 0 0
0 0 0 0 0 0 0 0 0 0 0
0 0 0 0 0 0 0 0 0 0 0
0 0 0 0 0 0 0 0 0 0 0
0 0 0 0 0 0 0 0 0 0 0
0 0 0 0 0 0 0 0 0 0 0
0 0 0 0 0 0 0 0 0 0 0
0 0 0 0 0 0 0 0 0 0 0
0 0 0 0 0 0 0 0 0 0 0
0 0 0 0 0 0 0 0 0 0 0
0 0 0 0 0 0 0 0 0 0 0
0 0 0 0 0 0 0 0 0 0 0
0 0 0 0 0 0 0 0 0 0 0
0 0 0 0 0 0 0 0 0 0 0