MODE 2
SIZE 11/70
LIMIT 0/25
COLOR LIMIT 4
STARS 1000/1500/2500
POWERUPS 1/0/1/0
13 7 7 16 7 7 13 7 7 7 16
7 7 7 7 7 7 7 7 7 7 7
7 7 11 7 7 7 7 11 7 7 7
7 7 7 7 7 7 7 7 7 7 7
7 7 7 7 7 14 7 7 7 7 7
7 0 7 0 7 0 7 0 7 0 0
0 7 0 7 0 7 0 7 0 7 0
0 7 0 7 0 7 0 7 0 7 0
0 0 7 0 7 0 7 0 7 0 7
0 7 7 0 0 7 7 0 0 7 7
0 0 9 0 0 0 7 0 0 0 7
0 7 7 0 0 7 7 0 0 7 8
0 0 7 0 0 0 7 0 0 0 7
0 7 7 0 0 7 7 0 0 7 7
0 0 7 0 0 0 7 0 0 0 7
0 7 7 0 0 7 7 0 0 7 7
0 0 7 0 0 0 7 0 0 0 7
0 7 7 0 0 7 7 0 0 7 7
0 0 0 7 7 7 0 7 7 7 0
0 0 0 7 7 0 0 7 7 0 0
0 0 0 0 7 0 0 0 7 0 0
0 0 0 7 7 0 0 7 7 0 0
0 0 0 0 7 0 0 0 7 0 0
0 0 0 7 7 0 0 7 7 0 0
0 0 0 0 7 0 0 0 7 0 0
0 0 0 7 7 0 0 7 7 0 0
0 0 0 0 7 0 0 0 7 0 0
0 0 0 7 7 0 0 7 7 0 0
20 20 20 20 20 20 20 20 20 20 20
20 20 20 20 20 20 20 20 20 20 20
20 20 20 20 20 20 20 20 20 20 20
0 0 0 0 0 0 0 0 0 0 0
0 0 0 0 0 0 0 0 0 0 0
0 0 0 0 0 0 0 0 0 0 0
0 0 0 0 0 0 0 0 0 0 0
0 0 0 0 0 0 0 0 0 0 0
0 0 0 0 0 0 0 0 0 0 0
0 0 0 0 0 0 0 0 0 0 0
0 0 0 0 0 0 0 0 0 0 0
0 0 0 0 0 0 0 0 0 0 0
0 0 0 0 0 0 0 0 0 0 0
0 0 0 0 0 0 0 0 0 0 0
0 0 0 0 0 0 0 0 0 0 0
0 0 0 0 0 0 0 0 0 0 0
0 0 0 0 0 0 0 0 0 0 0
0 0 0 0 0 0 0 0 0 0 0
0 0 0 0 0 0 0 0 0 0 0
0 0 0 0 0 0 0 0 0 0 0
0 0 0 0 0 0 0 0 0 0 0
0 0 0 0 0 0 0 0 0 0 0
0 0 0 0 0 0 0 0 0 0 0
0 0 0 0 0 0 0 0 0 0 0
0 0 0 0 0 0 0 0 0 0 0
0 0 0 0 0 0 0 0 0 0 0
0 0 0 0 0 0 0 0 0 0 0
0 0 0 0 0 0 0 0 0 0 0
0 0 0 0 0 0 0 0 0 0 0
0 0 0 0 0 0 0 0 0 0 0
0 0 0 0 0 0 0 0 0 0 0
0 0 0 0 0 0 0 0 0 0 0
0 0 0 0 0 0 0 0 0 0 0
0 0 0 0 0 0 0 0 0 0 0
0 0 0 0 0 0 0 0 0 0 0
0 0 0 0 0 0 0 0 0 0 0
0 0 0 0 0 0 0 0 0 0 0
0 0 0 0 0 0 0 0 0 0 0
0 0 0 0 0 0 0 0 0 0 0
0 0 0 0 0 0 0 0 0 0 0
0 0 0 0 0 0 0 0 0 0 0
0 0 0 0 0 0 0 0 0 0 0