MODE 2
SIZE 11/70
LIMIT 0/30
COLOR LIMIT 4
STARS 1000/1500/2500
POWERUPS 1/0/0/0
20 13 20 14 20 11 20 14 20 20 13
20 20 20 20 20 20 20 20 20 20 20
20 0 0 0 0 0 0 0 0 20 0
20 0 0 0 0 0 0 0 0 20 0
0 20 0 0 0 0 0 0 0 0 20
0 20 0 0 0 0 0 0 0 0 20
0 20 0 0 0 0 0 0 0 0 20
20 0 0 0 0 0 0 0 0 20 0
20 0 0 0 0 0 0 0 0 0 20
20 0 0 0 0 0 0 0 0 0 20
0 20 0 0 0 0 0 0 0 0 20
0 20 0 0 0 0 0 0 0 20 0
0 20 0 0 0 0 0 0 0 0 20
20 0 0 0 0 0 0 0 0 0 20
20 0 0 0 0 0 0 0 0 0 20
7 7 7 7 7 7 7 7 7 7 7
7 7 7 7 7 7 7 7 7 7 7
7 0 7 7 0 7 0 7 0 0 7
7 0 7 0 7 0 7 0 7 0 7
7 0 7 0 7 0 7 0 7 0 7
7 0 7 0 7 0 7 0 7 0 7
7 0 7 0 7 0 7 0 0 0 7
20 20 20 20 20 20 20 20 20 20 20
20 20 20 20 20 20 20 20 20 20 20
0 0 0 0 0 0 0 0 0 0 0
0 0 0 0 0 0 0 0 0 0 0
0 0 0 0 0 0 0 0 0 0 0
0 0 0 0 0 0 0 0 0 0 0
0 0 0 0 0 0 0 0 0 0 0
0 0 0 0 0 0 0 0 0 0 0
0 0 0 0 0 0 0 0 0 0 0
0 0 0 0 0 0 0 0 0 0 0
0 0 0 0 0 0 0 0 0 0 0
0 0 0 0 0 0 0 0 0 0 0
0 0 0 0 0 0 0 0 0 0 0
0 0 0 0 0 0 0 0 0 0 0
0 0 0 0 0 0 0 0 0 0 0
0 0 0 0 0 0 0 0 0 0 0
0 0 0 0 0 0 0 0 0 0 0
0 0 0 0 0 0 0 0 0 0 0
0 0 0 0 0 0 0 0 0 0 0
0 0 0 0 0 0 0 0 0 0 0
0 0 0 0 0 0 0 0 0 0 0
0 0 0 0 0 0 0 0 0 0 0
0 0 0 0 0 0 0 0 0 0 0
0 0 0 0 0 0 0 0 0 0 0
0 0 0 0 0 0 0 0 0 0 0
0 0 0 0 0 0 0 0 0 0 0
0 0 0 0 0 0 0 0 0 0 0
0 0 0 0 0 0 0 0 0 0 0
0 0 0 0 0 0 0 0 0 0 0
0 0 0 0 0 0 0 0 0 0 0
0 0 0 0 0 0 0 0 0 0 0
0 0 0 0 0 0 0 0 0 0 0
0 0 0 0 0 0 0 0 0 0 0
0 0 0 0 0 0 0 0 0 0 0
0 0 0 0 0 0 0 0 0 0 0
0 0 0 0 0 0 0 0 0 0 0
0 0 0 0 0 0 0 0 0 0 0
0 0 0 0 0 0 0 0 0 0 0
0 0 0 0 0 0 0 0 0 0 0
0 0 0 0 0 0 0 0 0 0 0
0 0 0 0 0 0 0 0 0 0 0
0 0 0 0 0 0 0 0 0 0 0
0 0 0 0 0 0 0 0 0 0 0
0 0 0 0 0 0 0 0 0 0 0
0 0 0 0 0 0 0 0 0 0 0
0 0 0 0 0 0 0 0 0 0 0
0 0 0 0 0 0 0 0 0 0 0
0 0 0 0 0 0 0 0 0 0 0