MODE 2
SIZE 11/70
LIMIT 0/15
COLOR LIMIT 4
STARS 1000/1500/2500
POWERUPS 0/1/1/0
11 7 7 12 7 7 13 7 7 7 14
7 7 7 7 7 7 7 7 7 7 0
0 7 0 7 0 7 0 7 0 7 0
0 7 7 7 7 7 7 7 7 0 0
0 0 7 0 7 0 7 0 7 0 0
0 0 7 7 7 7 7 7 0 0 0
0 0 0 7 0 7 0 7 0 0 0
0 0 7 7 7 7 7 7 0 0 0
0 0 0 7 0 7 0 7 0 0 0
0 0 7 7 7 7 7 7 0 0 0
0 0 0 7 0 7 0 7 0 0 0
0 0 7 0 0 0 0 7 0 0 0
0 0 7 7 0 0 0 7 7 0 0
0 7 0 0 0 0 0 0 7 0 0
0 7 7 0 0 0 0 0 7 7 0
0 0 7 0 0 0 0 7 0 0 0
0 0 7 7 0 0 0 7 7 0 0
0 0 0 7 0 0 7 0 0 0 0
0 0 0 7 7 0 7 7 0 0 0
0 0 0 0 7 7 0 0 0 0 0
0 0 0 0 0 7 0 0 0 0 0
0 0 0 0 7 7 0 0 0 0 0
0 0 0 0 0 7 0 0 0 0 0
0 0 0 0 7 7 0 0 0 0 0
0 0 0 0 0 7 0 0 0 0 0
0 0 0 0 7 7 0 0 0 0 0
0 0 0 0 0 7 0 0 0 0 0
0 0 0 0 0 0 0 0 0 0 0
0 0 0 0 0 0 0 0 0 0 0
0 0 0 0 0 0 0 0 0 0 0
0 0 0 0 0 0 0 0 0 0 0
0 0 0 0 0 0 0 0 0 0 0
0 0 0 0 0 0 0 0 0 0 0
0 0 0 0 0 0 0 0 0 0 0
0 0 0 0 0 0 0 0 0 0 0
0 0 0 0 0 0 0 0 0 0 0
0 0 0 0 0 0 0 0 0 0 0
0 0 0 0 0 0 0 0 0 0 0
0 0 0 0 0 0 0 0 0 0 0
0 0 0 0 0 0 0 0 0 0 0
0 0 0 0 0 0 0 0 0 0 0
0 0 0 0 0 0 0 0 0 0 0
0 0 0 0 0 0 0 0 0 0 0
0 0 0 0 0 0 0 0 0 0 0
0 0 0 0 0 0 0 0 0 0 0
0 0 0 0 0 0 0 0 0 0 0
0 0 0 0 0 0 0 0 0 0 0
0 0 0 0 0 0 0 0 0 0 0
0 0 0 0 0 0 0 0 0 0 0
0 0 0 0 0 0 0 0 0 0 0
0 0 0 0 0 0 0 0 0 0 0
0 0 0 0 0 0 0 0 0 0 0
0 0 0 0 0 0 0 0 0 0 0
0 0 0 0 0 0 0 0 0 0 0
0 0 0 0 0 0 0 0 0 0 0
0 0 0 0 0 0 0 0 0 0 0
0 0 0 0 0 0 0 0 0 0 0
0 0 0 0 0 0 0 0 0 0 0
0 0 0 0 0 0 0 0 0 0 0
0 0 0 0 0 0 0 0 0 0 0
0 0 0 0 0 0 0 0 0 0 0
0 0 0 0 0 0 0 0 0 0 0
0 0 0 0 0 0 0 0 0 0 0
0 0 0 0 0 0 0 0 0 0 0
0 0 0 0 0 0 0 0 0 0 0
0 0 0 0 0 0 0 0 0 0 0
0 0 0 0 0 0 0 0 0 0 0
0 0 0 0 0 0 0 0 0 0 0
0 0 0 0 0 0 0 0 0 0 0
0 0 0 0 0 0 0 0 0 0 0