MODE 2
SIZE 11/70
LIMIT 0/35
COLOR LIMIT 4
STARS 1200/2500/5000
POWERUPS 0/1/0/1
1 1 1 1 5 1 5 1 1 1 1
0 0 0 5 0 0 5 0 0 0 0
0 0 2 20 3 0 3 20 2 0 0
0 2 5 2 14 11 2 5 2 0 0
0 2 5 2 3 0 3 2 5 2 0
3 2 20 3 0 0 3 2 20 3 0
0 3 20 3 0 6 0 3 3 20 0
0 20 5 5 6 6 5 5 5 20 0
0 20 5 5 6 0 6 5 5 5 20
0 0 17 6 0 0 6 17 0 0 0
20 20 20 20 0 0 0 20 20 20 20
20 0 6 6 6 6 6 6 0 20 0
0 20 2 2 2 11 2 2 2 20 0
0 20 3 3 3 3 3 3 20 0 0
0 0 20 1 1 12 1 1 20 0 0
0 18 18 0 0 17 0 18 18 0 0
0 18 7 0 0 13 0 0 7 18 0
7 7 0 7 7 7 7 0 7 7 0
0 7 0 7 0 0 0 7 0 7 0
0 7 18 7 0 0 7 18 7 0 0
0 0 0 0 7 0 7 0 0 0 0
0 0 0 0 7 7 0 0 0 0 0
0 0 0 0 0 7 0 0 0 0 0
0 0 0 0 0 0 0 0 0 0 0
0 0 0 0 0 0 0 0 0 0 0
0 0 0 0 0 0 0 0 0 0 0
0 0 0 0 0 0 0 0 0 0 0
0 0 0 0 0 0 0 0 0 0 0
0 0 0 0 0 0 0 0 0 0 0
0 0 0 0 0 0 0 0 0 0 0
0 0 0 0 0 0 0 0 0 0 0
0 0 0 0 0 0 0 0 0 0 0
0 0 0 0 0 0 0 0 0 0 0
0 0 0 0 0 0 0 0 0 0 0
0 0 0 0 0 0 0 0 0 0 0
0 0 0 0 0 0 0 0 0 0 0
0 0 0 0 0 0 0 0 0 0 0
0 0 0 0 0 0 0 0 0 0 0
0 0 0 0 0 0 0 0 0 0 0
0 0 0 0 0 0 0 0 0 0 0
0 0 0 0 0 0 0 0 0 0 0
0 0 0 0 0 0 0 0 0 0 0
0 0 0 0 0 0 0 0 0 0 0
0 0 0 0 0 0 0 0 0 0 0
0 0 0 0 0 0 0 0 0 0 0
0 0 0 0 0 0 0 0 0 0 0
0 0 0 0 0 0 0 0 0 0 0
0 0 0 0 0 0 0 0 0 0 0
0 0 0 0 0 0 0 0 0 0 0
0 0 0 0 0 0 0 0 0 0 0
0 0 0 0 0 0 0 0 0 0 0
0 0 0 0 0 0 0 0 0 0 0
0 0 0 0 0 0 0 0 0 0 0
0 0 0 0 0 0 0 0 0 0 0
0 0 0 0 0 0 0 0 0 0 0
0 0 0 0 0 0 0 0 0 0 0
0 0 0 0 0 0 0 0 0 0 0
0 0 0 0 0 0 0 0 0 0 0
0 0 0 0 0 0 0 0 0 0 0
0 0 0 0 0 0 0 0 0 0 0
0 0 0 0 0 0 0 0 0 0 0
0 0 0 0 0 0 0 0 0 0 0
0 0 0 0 0 0 0 0 0 0 0
0 0 0 0 0 0 0 0 0 0 0
0 0 0 0 0 0 0 0 0 0 0
0 0 0 0 0 0 0 0 0 0 0
0 0 0 0 0 0 0 0 0 0 0
0 0 0 0 0 0 0 0 0 0 0
0 0 0 0 0 0 0 0 0 0 0
0 0 0 0 0 0 0 0 0 0 0