MODE 2
SIZE 11/70
LIMIT 0/32
COLOR LIMIT 4
STARS 2500/5000/8500
POWERUPS 1/0/0/0
7 7 7 7 7 7 7 0 0 0 0
20 20 20 20 20 7 7 0 0 0 0
20 11 20 20 1 20 7 7 0 0 0
20 20 9 20 20 7 7 0 0 0 0
7 7 7 7 7 8 7 7 7 7 7
0 0 0 7 7 20 20 20 20 20 0
0 0 0 7 7 20 13 20 20 3 20
0 0 0 7 7 20 20 9 20 20 0
7 7 7 7 7 8 7 7 7 7 7
20 20 20 20 20 7 7 0 0 0 0
20 12 20 20 2 20 7 7 0 0 0
20 20 9 20 20 7 7 0 0 0 0
7 7 7 7 7 8 7 7 7 7 7
0 0 0 7 7 20 20 20 20 20 0
0 0 0 7 7 20 14 20 20 4 20
0 0 0 7 7 20 20 9 20 20 0
7 7 7 7 7 8 7 7 7 7 7
20 20 20 20 20 7 7 0 0 0 0
20 15 20 20 5 20 7 7 0 0 0
20 20 9 20 20 7 7 0 0 0 0
7 7 7 7 7 8 7 7 7 7 7
0 0 0 7 7 20 20 20 20 20 0
0 0 0 7 7 20 6 20 20 16 20
0 0 0 7 7 20 20 9 20 20 0
7 7 7 7 7 8 7 7 7 7 7
20 20 20 20 20 7 7 0 0 0 0
20 11 20 20 1 20 7 7 0 0 0
20 20 9 20 20 7 7 0 0 0 0
7 7 7 7 7 7 7 0 0 0 0
0 0 0 0 0 0 0 0 0 0 0
0 0 0 0 0 0 0 0 0 0 0
0 0 0 0 0 0 0 0 0 0 0
0 0 0 0 0 0 0 0 0 0 0
0 0 0 0 0 0 0 0 0 0 0
0 0 0 0 0 0 0 0 0 0 0
0 0 0 0 0 0 0 0 0 0 0
0 0 0 0 0 0 0 0 0 0 0
0 0 0 0 0 0 0 0 0 0 0
0 0 0 0 0 0 0 0 0 0 0
0 0 0 0 0 0 0 0 0 0 0
0 0 0 0 0 0 0 0 0 0 0
0 0 0 0 0 0 0 0 0 0 0
0 0 0 0 0 0 0 0 0 0 0
0 0 0 0 0 0 0 0 0 0 0
0 0 0 0 0 0 0 0 0 0 0
0 0 0 0 0 0 0 0 0 0 0
0 0 0 0 0 0 0 0 0 0 0
0 0 0 0 0 0 0 0 0 0 0
0 0 0 0 0 0 0 0 0 0 0
0 0 0 0 0 0 0 0 0 0 0
0 0 0 0 0 0 0 0 0 0 0
0 0 0 0 0 0 0 0 0 0 0
0 0 0 0 0 0 0 0 0 0 0
0 0 0 0 0 0 0 0 0 0 0
0 0 0 0 0 0 0 0 0 0 0
0 0 0 0 0 0 0 0 0 0 0
0 0 0 0 0 0 0 0 0 0 0
0 0 0 0 0 0 0 0 0 0 0
0 0 0 0 0 0 0 0 0 0 0
0 0 0 0 0 0 0 0 0 0 0
0 0 0 0 0 0 0 0 0 0 0
0 0 0 0 0 0 0 0 0 0 0
0 0 0 0 0 0 0 0 0 0 0
0 0 0 0 0 0 0 0 0 0 0
0 0 0 0 0 0 0 0 0 0 0
0 0 0 0 0 0 0 0 0 0 0
0 0 0 0 0 0 0 0 0 0 0
0 0 0 0 0 0 0 0 0 0 0
0 0 0 0 0 0 0 0 0 0 0
0 0 0 0 0 0 0 0 0 0 0