MODE 2
SIZE 11/70
LIMIT 0/40
COLOR LIMIT 4
STARS 1000/2700/5200
POWERUPS 0/0/0/0
20 20 20 11 20 20 20 20 11 20 20
0 0 18 18 18 12 18 18 18 0 0
0 0 0 0 0 20 0 1 1 0 0
0 0 0 0 20 0 1 17 1 18 0
0 0 3 3 20 20 20 20 1 18 0
2 2 2 3 0 0 20 0 18 0 0
2 17 2 3 0 18 20 18 18 0 0
2 2 18 18 18 20 18 1 1 0 0
0 0 18 0 0 20 0 1 13 1 18
0 18 3 3 20 20 20 20 1 18 0
0 2 2 2 3 0 0 20 0 18 0
2 17 2 3 0 0 20 18 18 0 0
0 2 2 0 0 18 20 18 0 0 0
0 0 18 18 18 20 0 1 1 0 0
0 0 18 0 0 20 0 1 17 1 0
0 18 3 3 20 20 20 20 1 0 0
0 2 2 2 3 0 0 20 0 0 0
2 17 2 3 0 0 20 0 0 0 0
0 2 2 0 7 7 20 7 7 0 0
0 0 0 7 7 20 7 7 0 0 0
0 0 0 7 7 20 7 7 0 0 0
0 1 1 1 20 5 5 5 5 0 0
0 0 1 20 20 3 3 5 5 0 0
0 0 1 1 3 2 2 2 0 0 0
0 0 0 0 0 3 2 13 2 0 0
0 0 0 0 0 0 2 2 0 0 0
0 0 0 0 0 0 0 0 0 0 0
0 0 0 0 0 0 0 0 0 0 0
0 0 0 0 0 0 0 0 0 0 0
0 0 0 0 0 0 0 0 0 0 0
0 0 0 0 0 0 0 0 0 0 0
0 0 0 0 0 0 0 0 0 0 0
0 0 0 0 0 0 0 0 0 0 0
0 0 0 0 0 0 0 0 0 0 0
0 0 0 0 0 0 0 0 0 0 0
0 0 0 0 0 0 0 0 0 0 0
0 0 0 0 0 0 0 0 0 0 0
0 0 0 0 0 0 0 0 0 0 0
0 0 0 0 0 0 0 0 0 0 0
0 0 0 0 0 0 0 0 0 0 0
0 0 0 0 0 0 0 0 0 0 0
0 0 0 0 0 0 0 0 0 0 0
0 0 0 0 0 0 0 0 0 0 0
0 0 0 0 0 0 0 0 0 0 0
0 0 0 0 0 0 0 0 0 0 0
0 0 0 0 0 0 0 0 0 0 0
0 0 0 0 0 0 0 0 0 0 0
0 0 0 0 0 0 0 0 0 0 0
0 0 0 0 0 0 0 0 0 0 0
0 0 0 0 0 0 0 0 0 0 0
0 0 0 0 0 0 0 0 0 0 0
0 0 0 0 0 0 0 0 0 0 0
0 0 0 0 0 0 0 0 0 0 0
0 0 0 0 0 0 0 0 0 0 0
0 0 0 0 0 0 0 0 0 0 0
0 0 0 0 0 0 0 0 0 0 0
0 0 0 0 0 0 0 0 0 0 0
0 0 0 0 0 0 0 0 0 0 0
0 0 0 0 0 0 0 0 0 0 0
0 0 0 0 0 0 0 0 0 0 0
0 0 0 0 0 0 0 0 0 0 0
0 0 0 0 0 0 0 0 0 0 0
0 0 0 0 0 0 0 0 0 0 0
0 0 0 0 0 0 0 0 0 0 0
0 0 0 0 0 0 0 0 0 0 0
0 0 0 0 0 0 0 0 0 0 0
0 0 0 0 0 0 0 0 0 0 0
0 0 0 0 0 0 0 0 0 0 0
0 0 0 0 0 0 0 0 0 0 0
0 0 0 0 0 0 0 0 0 0 0