MODE 2
SIZE 11/70
LIMIT 0/35
COLOR LIMIT 4
STARS 1600/2800/4900
POWERUPS 0/0/0/0
20 20 20 20 20 16 20 20 20 20 20
0 0 0 20 7 20 20 20 20 0 0
0 0 20 20 7 20 20 20 0 0 0
20 20 20 7 20 20 7 0 0 0 0
5 5 5 7 18 11 18 7 5 5 5
5 5 7 2 2 2 2 7 5 5 0
0 0 7 18 18 20 20 20 20 20 20
0 7 7 7 7 7 7 7 20 0 0
0 0 20 20 20 20 20 20 0 0 0
20 20 20 20 20 20 20 20 20 20 0
0 7 7 7 20 12 20 7 7 7 0
20 20 20 20 1 1 20 20 20 20 0
0 0 7 1 1 3 1 1 7 0 0
0 0 7 1 3 3 1 7 0 0 0
20 20 20 20 18 3 18 20 20 20 20
0 0 0 7 1 1 7 0 0 0 0
0 0 0 2 7 1 7 2 0 0 0
3 3 2 3 7 7 3 2 3 3 0
0 0 2 6 6 13 6 6 2 0 0
2 2 6 20 20 20 20 6 2 2 0
0 0 7 6 6 8 6 6 7 0 0
0 7 7 7 7 7 7 7 7 0 0
0 0 7 7 7 7 7 7 7 0 0
0 7 7 7 0 0 7 7 7 0 0
0 7 7 7 0 0 0 7 7 7 0
0 0 0 0 0 0 0 0 0 0 0
0 0 0 0 0 0 0 0 0 0 0
0 0 0 0 0 0 0 0 0 0 0
0 0 0 0 0 0 0 0 0 0 0
0 0 0 0 0 0 0 0 0 0 0
0 0 0 0 0 0 0 0 0 0 0
0 0 0 0 0 0 0 0 0 0 0
0 0 0 0 0 0 0 0 0 0 0
0 0 0 0 0 0 0 0 0 0 0
0 0 0 0 0 0 0 0 0 0 0
0 0 0 0 0 0 0 0 0 0 0
0 0 0 0 0 0 0 0 0 0 0
0 0 0 0 0 0 0 0 0 0 0
0 0 0 0 0 0 0 0 0 0 0
0 0 0 0 0 0 0 0 0 0 0
0 0 0 0 0 0 0 0 0 0 0
0 0 0 0 0 0 0 0 0 0 0
0 0 0 0 0 0 0 0 0 0 0
0 0 0 0 0 0 0 0 0 0 0
0 0 0 0 0 0 0 0 0 0 0
0 0 0 0 0 0 0 0 0 0 0
0 0 0 0 0 0 0 0 0 0 0
0 0 0 0 0 0 0 0 0 0 0
0 0 0 0 0 0 0 0 0 0 0
0 0 0 0 0 0 0 0 0 0 0
0 0 0 0 0 0 0 0 0 0 0
0 0 0 0 0 0 0 0 0 0 0
0 0 0 0 0 0 0 0 0 0 0
0 0 0 0 0 0 0 0 0 0 0
0 0 0 0 0 0 0 0 0 0 0
0 0 0 0 0 0 0 0 0 0 0
0 0 0 0 0 0 0 0 0 0 0
0 0 0 0 0 0 0 0 0 0 0
0 0 0 0 0 0 0 0 0 0 0
0 0 0 0 0 0 0 0 0 0 0
0 0 0 0 0 0 0 0 0 0 0
0 0 0 0 0 0 0 0 0 0 0
0 0 0 0 0 0 0 0 0 0 0
0 0 0 0 0 0 0 0 0 0 0
0 0 0 0 0 0 0 0 0 0 0
0 0 0 0 0 0 0 0 0 0 0
0 0 0 0 0 0 0 0 0 0 0
0 0 0 0 0 0 0 0 0 0 0
0 0 0 0 0 0 0 0 0 0 0
0 0 0 0 0 0 0 0 0 0 0