MODE 2
SIZE 11/70
LIMIT 0/35
COLOR LIMIT 4
STARS 1800/3200/5500
POWERUPS 0/0/0/0
0 18 18 18 0 11 0 18 18 18 0
18 3 3 3 3 3 3 3 3 18 0
18 3 1 1 1 15 1 1 1 3 18
20 20 20 20 2 2 20 20 20 20 0
20 20 20 20 5 13 5 20 20 20 20
0 1 3 2 5 5 2 3 1 0 0
0 0 1 3 2 2 2 3 1 0 0
20 20 20 20 20 20 20 20 20 20 0
20 20 20 20 20 20 20 20 20 20 20
0 8 0 1 3 3 1 0 8 0 0
0 0 0 6 1 3 1 6 0 0 0
0 4 4 4 20 20 4 4 4 0 0
6 6 6 4 3 14 3 4 6 6 6
0 1 4 1 3 3 1 4 1 0 0
0 1 16 1 18 8 18 1 16 1 0
1 1 20 9 18 18 9 20 1 1 0
0 0 0 20 20 20 20 20 0 0 0
7 7 20 7 7 7 7 20 7 7 7
7 7 20 7 7 7 7 7 20 7 7
7 7 7 7 7 7 7 7 7 7 0
0 0 0 0 0 0 0 0 0 0 0
0 0 0 0 0 0 0 0 0 0 0
0 0 0 0 0 0 0 0 0 0 0
0 0 0 0 0 0 0 0 0 0 0
0 0 0 0 0 0 0 0 0 0 0
0 0 0 0 0 0 0 0 0 0 0
0 0 0 0 0 0 0 0 0 0 0
0 0 0 0 0 0 0 0 0 0 0
0 0 0 0 0 0 0 0 0 0 0
0 0 0 0 0 0 0 0 0 0 0
0 0 0 0 0 0 0 0 0 0 0
0 0 0 0 0 0 0 0 0 0 0
0 0 0 0 0 0 0 0 0 0 0
0 0 0 0 0 0 0 0 0 0 0
0 0 0 0 0 0 0 0 0 0 0
0 0 0 0 0 0 0 0 0 0 0
0 0 0 0 0 0 0 0 0 0 0
0 0 0 0 0 0 0 0 0 0 0
0 0 0 0 0 0 0 0 0 0 0
0 0 0 0 0 0 0 0 0 0 0
0 0 0 0 0 0 0 0 0 0 0
0 0 0 0 0 0 0 0 0 0 0
0 0 0 0 0 0 0 0 0 0 0
0 0 0 0 0 0 0 0 0 0 0
0 0 0 0 0 0 0 0 0 0 0
0 0 0 0 0 0 0 0 0 0 0
0 0 0 0 0 0 0 0 0 0 0
0 0 0 0 0 0 0 0 0 0 0
0 0 0 0 0 0 0 0 0 0 0
0 0 0 0 0 0 0 0 0 0 0
0 0 0 0 0 0 0 0 0 0 0
0 0 0 0 0 0 0 0 0 0 0
0 0 0 0 0 0 0 0 0 0 0
0 0 0 0 0 0 0 0 0 0 0
0 0 0 0 0 0 0 0 0 0 0
0 0 0 0 0 0 0 0 0 0 0
0 0 0 0 0 0 0 0 0 0 0
0 0 0 0 0 0 0 0 0 0 0
0 0 0 0 0 0 0 0 0 0 0
0 0 0 0 0 0 0 0 0 0 0
0 0 0 0 0 0 0 0 0 0 0
0 0 0 0 0 0 0 0 0 0 0
0 0 0 0 0 0 0 0 0 0 0
0 0 0 0 0 0 0 0 0 0 0
0 0 0 0 0 0 0 0 0 0 0
0 0 0 0 0 0 0 0 0 0 0
0 0 0 0 0 0 0 0 0 0 0
0 0 0 0 0 0 0 0 0 0 0
0 0 0 0 0 0 0 0 0 0 0
0 0 0 0 0 0 0 0 0 0 0