MODE 2
SIZE 11/70
LIMIT 0/42
COLOR LIMIT 4
STARS 1800/3200/5800
POWERUPS 1/0/0/0
2 2 2 3 3 20 3 3 2 2 2
0 0 0 3 20 20 3 0 0 0 0
20 20 20 20 20 11 20 20 20 20 20
0 0 0 0 3 3 0 0 0 0 0
2 2 2 2 2 3 2 2 2 2 2
20 20 20 20 20 20 20 20 20 20 20
1 1 1 1 1 4 1 1 1 1 1
0 0 0 0 4 4 0 0 0 0 0
20 20 20 20 20 12 20 20 20 20 20
0 0 0 4 20 20 4 0 0 0 0
1 1 1 4 4 20 4 4 1 1 1
20 20 20 20 20 20 20 20 20 20 20
5 5 5 6 6 20 6 6 5 5 5
0 0 0 6 20 20 6 0 0 0 0
20 20 20 20 20 13 20 20 20 20 20
0 0 0 0 6 6 0 0 0 0 0
5 5 5 5 5 6 5 5 5 5 5
20 20 20 20 20 20 20 20 20 20 20
3 3 3 3 3 1 3 3 3 3 3
0 0 0 0 1 1 0 0 0 0 0
20 20 20 20 20 14 20 20 20 20 20
0 0 0 1 20 20 1 0 0 0 0
3 3 3 1 1 20 1 1 3 3 3
20 20 20 20 20 20 20 20 20 20 20
0 0 0 0 0 0 0 0 0 0 0
0 0 0 0 0 0 0 0 0 0 0
0 0 0 0 0 0 0 0 0 0 0
0 0 0 0 0 0 0 0 0 0 0
0 0 0 0 0 0 0 0 0 0 0
0 0 0 0 0 0 0 0 0 0 0
0 0 0 0 0 0 0 0 0 0 0
0 0 0 0 0 0 0 0 0 0 0
0 0 0 0 0 0 0 0 0 0 0
0 0 0 0 0 0 0 0 0 0 0
0 0 0 0 0 0 0 0 0 0 0
0 0 0 0 0 0 0 0 0 0 0
0 0 0 0 0 0 0 0 0 0 0
0 0 0 0 0 0 0 0 0 0 0
0 0 0 0 0 0 0 0 0 0 0
0 0 0 0 0 0 0 0 0 0 0
0 0 0 0 0 0 0 0 0 0 0
0 0 0 0 0 0 0 0 0 0 0
0 0 0 0 0 0 0 0 0 0 0
0 0 0 0 0 0 0 0 0 0 0
0 0 0 0 0 0 0 0 0 0 0
0 0 0 0 0 0 0 0 0 0 0
0 0 0 0 0 0 0 0 0 0 0
0 0 0 0 0 0 0 0 0 0 0
0 0 0 0 0 0 0 0 0 0 0
0 0 0 0 0 0 0 0 0 0 0
0 0 0 0 0 0 0 0 0 0 0
0 0 0 0 0 0 0 0 0 0 0
0 0 0 0 0 0 0 0 0 0 0
0 0 0 0 0 0 0 0 0 0 0
0 0 0 0 0 0 0 0 0 0 0
0 0 0 0 0 0 0 0 0 0 0
0 0 0 0 0 0 0 0 0 0 0
0 0 0 0 0 0 0 0 0 0 0
0 0 0 0 0 0 0 0 0 0 0
0 0 0 0 0 0 0 0 0 0 0
0 0 0 0 0 0 0 0 0 0 0
0 0 0 0 0 0 0 0 0 0 0
0 0 0 0 0 0 0 0 0 0 0
0 0 0 0 0 0 0 0 0 0 0
0 0 0 0 0 0 0 0 0 0 0
0 0 0 0 0 0 0 0 0 0 0
0 0 0 0 0 0 0 0 0 0 0
0 0 0 0 0 0 0 0 0 0 0
0 0 0 0 0 0 0 0 0 0 0
0 0 0 0 0 0 0 0 0 0 0