MODE 2
SIZE 11/70
LIMIT 0/55
COLOR LIMIT 4
STARS 1800/3300/4900
POWERUPS 1/1/0/0
3 3 3 3 17 17 17 3 3 3 3
0 1 1 1 20 20 1 1 1 0 0
2 2 2 2 20 15 20 2 2 2 2
0 5 5 5 20 20 5 5 5 0 0
6 6 6 6 17 17 17 6 6 6 6
0 4 4 4 20 20 4 4 4 0 0
1 1 1 1 20 11 20 1 1 1 1
0 3 3 3 20 20 3 3 3 0 0
2 2 2 2 17 17 17 2 2 2 2
0 5 5 5 20 20 5 5 5 0 0
6 6 6 6 20 12 20 6 6 6 6
20 20 20 20 20 20 20 20 20 20 0
20 20 20 20 0 0 0 20 20 20 20
18 18 18 0 0 0 0 18 18 18 0
20 20 20 20 0 0 0 20 20 20 20
20 20 20 20 20 20 20 20 20 20 0
6 6 6 6 20 13 20 6 6 6 6
0 1 1 1 20 20 1 1 1 0 0
3 3 3 3 17 17 17 3 3 3 3
0 2 2 2 20 20 2 2 2 0 0
5 5 5 5 20 14 20 5 5 5 5
0 4 4 4 20 20 4 4 4 0 0
1 1 1 1 17 17 17 1 1 1 1
0 3 3 3 20 20 3 3 3 0 0
6 6 6 6 20 16 20 6 6 6 6
0 0 0 0 20 20 0 0 0 0 0
7 7 7 7 7 7 7 7 7 7 7
7 7 7 7 7 7 7 7 7 7 0
0 0 0 0 0 0 0 0 0 0 0
0 0 0 0 0 0 0 0 0 0 0
0 0 0 0 0 0 0 0 0 0 0
0 0 0 0 0 0 0 0 0 0 0
0 0 0 0 0 0 0 0 0 0 0
0 0 0 0 0 0 0 0 0 0 0
0 0 0 0 0 0 0 0 0 0 0
0 0 0 0 0 0 0 0 0 0 0
0 0 0 0 0 0 0 0 0 0 0
0 0 0 0 0 0 0 0 0 0 0
0 0 0 0 0 0 0 0 0 0 0
0 0 0 0 0 0 0 0 0 0 0
0 0 0 0 0 0 0 0 0 0 0
0 0 0 0 0 0 0 0 0 0 0
0 0 0 0 0 0 0 0 0 0 0
0 0 0 0 0 0 0 0 0 0 0
0 0 0 0 0 0 0 0 0 0 0
0 0 0 0 0 0 0 0 0 0 0
0 0 0 0 0 0 0 0 0 0 0
0 0 0 0 0 0 0 0 0 0 0
0 0 0 0 0 0 0 0 0 0 0
0 0 0 0 0 0 0 0 0 0 0
0 0 0 0 0 0 0 0 0 0 0
0 0 0 0 0 0 0 0 0 0 0
0 0 0 0 0 0 0 0 0 0 0
0 0 0 0 0 0 0 0 0 0 0
0 0 0 0 0 0 0 0 0 0 0
0 0 0 0 0 0 0 0 0 0 0
0 0 0 0 0 0 0 0 0 0 0
0 0 0 0 0 0 0 0 0 0 0
0 0 0 0 0 0 0 0 0 0 0
0 0 0 0 0 0 0 0 0 0 0
0 0 0 0 0 0 0 0 0 0 0
0 0 0 0 0 0 0 0 0 0 0
0 0 0 0 0 0 0 0 0 0 0
0 0 0 0 0 0 0 0 0 0 0
0 0 0 0 0 0 0 0 0 0 0
0 0 0 0 0 0 0 0 0 0 0
0 0 0 0 0 0 0 0 0 0 0
0 0 0 0 0 0 0 0 0 0 0
0 0 0 0 0 0 0 0 0 0 0
0 0 0 0 0 0 0 0 0 0 0