MODE 2
SIZE 11/70
LIMIT 0/45
COLOR LIMIT 4
STARS 2000/4200/7400
POWERUPS 0/0/0/0
1 1 1 5 5 5 5 5 1 1 1
17 1 2 20 20 20 20 2 1 17 0
3 3 3 2 20 11 20 2 3 3 3
1 4 4 4 20 20 4 4 4 1 0
1 1 1 5 5 5 5 5 1 1 1
17 1 2 20 20 20 20 2 1 17 0
3 3 3 2 20 12 20 2 3 3 3
1 4 4 4 20 20 4 4 4 1 0
1 1 1 5 5 5 5 5 1 1 1
17 1 2 20 20 20 20 2 1 17 0
3 3 3 2 20 13 20 2 3 3 3
1 4 4 4 20 20 4 4 4 1 0
1 1 1 5 5 5 5 5 1 1 1
17 1 2 20 20 20 20 2 1 17 0
3 3 3 2 20 14 20 2 3 3 3
1 4 4 4 20 20 4 4 4 1 0
1 1 1 5 5 5 5 5 1 1 1
17 1 2 20 20 20 20 2 1 17 0
3 3 3 2 20 15 20 2 3 3 3
1 6 6 0 20 20 0 6 6 1 0
1 6 0 0 0 0 0 0 0 6 1
6 0 0 0 0 0 0 0 0 6 0
0 0 0 0 0 0 0 0 0 0 0
0 0 0 0 0 0 0 0 0 0 0
0 0 0 0 0 0 0 0 0 0 0
0 0 0 0 0 0 0 0 0 0 0
0 0 0 0 0 0 0 0 0 0 0
0 0 0 0 0 0 0 0 0 0 0
0 0 0 0 0 0 0 0 0 0 0
0 0 0 0 0 0 0 0 0 0 0
0 0 0 0 0 0 0 0 0 0 0
0 0 0 0 0 0 0 0 0 0 0
0 0 0 0 0 0 0 0 0 0 0
0 0 0 0 0 0 0 0 0 0 0
0 0 0 0 0 0 0 0 0 0 0
0 0 0 0 0 0 0 0 0 0 0
0 0 0 0 0 0 0 0 0 0 0
0 0 0 0 0 0 0 0 0 0 0
0 0 0 0 0 0 0 0 0 0 0
0 0 0 0 0 0 0 0 0 0 0
0 0 0 0 0 0 0 0 0 0 0
0 0 0 0 0 0 0 0 0 0 0
0 0 0 0 0 0 0 0 0 0 0
0 0 0 0 0 0 0 0 0 0 0
0 0 0 0 0 0 0 0 0 0 0
0 0 0 0 0 0 0 0 0 0 0
0 0 0 0 0 0 0 0 0 0 0
0 0 0 0 0 0 0 0 0 0 0
0 0 0 0 0 0 0 0 0 0 0
0 0 0 0 0 0 0 0 0 0 0
0 0 0 0 0 0 0 0 0 0 0
0 0 0 0 0 0 0 0 0 0 0
0 0 0 0 0 0 0 0 0 0 0
0 0 0 0 0 0 0 0 0 0 0
0 0 0 0 0 0 0 0 0 0 0
0 0 0 0 0 0 0 0 0 0 0
0 0 0 0 0 0 0 0 0 0 0
0 0 0 0 0 0 0 0 0 0 0
0 0 0 0 0 0 0 0 0 0 0
0 0 0 0 0 0 0 0 0 0 0
0 0 0 0 0 0 0 0 0 0 0
0 0 0 0 0 0 0 0 0 0 0
0 0 0 0 0 0 0 0 0 0 0
0 0 0 0 0 0 0 0 0 0 0
0 0 0 0 0 0 0 0 0 0 0
0 0 0 0 0 0 0 0 0 0 0
0 0 0 0 0 0 0 0 0 0 0
0 0 0 0 0 0 0 0 0 0 0
0 0 0 0 0 0 0 0 0 0 0
0 0 0 0 0 0 0 0 0 0 0