MODE 2
SIZE 11/70
LIMIT 0/45
COLOR LIMIT 4
STARS 2000/4200/7400
POWERUPS 1/0/0/0
5 5 5 5 5 20 5 5 5 5 5
3 3 3 3 20 20 3 3 3 3 3
1 1 1 1 20 16 20 1 1 1 1
2 2 2 20 2 2 20 2 2 2 2
4 4 4 20 4 11 4 20 4 4 4
6 6 20 6 6 6 6 20 6 6 6
20 20 20 20 20 20 20 20 20 20 20
0 18 18 14 18 18 15 18 18 0 0
20 20 20 20 20 20 20 20 20 20 20
3 3 20 3 3 3 3 20 3 3 3
1 1 1 20 1 12 1 20 1 1 1
2 2 2 20 2 2 20 2 2 2 2
4 4 4 4 20 13 20 4 4 4 4
5 5 5 5 20 20 5 5 5 5 5
6 6 6 6 6 20 6 6 6 6 6
20 20 20 20 20 20 20 20 20 20 20
0 18 18 8 18 18 8 18 18 0 0
20 20 20 20 20 20 20 20 20 20 20
0 7 7 7 0 0 0 7 7 7 0
7 7 7 0 0 0 0 7 7 7 0
7 7 7 0 0 0 0 0 7 7 7
7 7 0 0 0 0 0 0 7 7 0
7 7 0 0 0 0 0 0 0 7 7
7 0 0 0 0 0 0 0 0 7 0
7 0 0 0 0 0 0 0 0 0 7
0 0 0 0 0 0 0 0 0 0 0
0 0 0 0 0 0 0 0 0 0 0
0 0 0 0 0 0 0 0 0 0 0
0 0 0 0 0 0 0 0 0 0 0
0 0 0 0 0 0 0 0 0 0 0
0 0 0 0 0 0 0 0 0 0 0
0 0 0 0 0 0 0 0 0 0 0
0 0 0 0 0 0 0 0 0 0 0
0 0 0 0 0 0 0 0 0 0 0
0 0 0 0 0 0 0 0 0 0 0
0 0 0 0 0 0 0 0 0 0 0
0 0 0 0 0 0 0 0 0 0 0
0 0 0 0 0 0 0 0 0 0 0
0 0 0 0 0 0 0 0 0 0 0
0 0 0 0 0 0 0 0 0 0 0
0 0 0 0 0 0 0 0 0 0 0
0 0 0 0 0 0 0 0 0 0 0
0 0 0 0 0 0 0 0 0 0 0
0 0 0 0 0 0 0 0 0 0 0
0 0 0 0 0 0 0 0 0 0 0
0 0 0 0 0 0 0 0 0 0 0
0 0 0 0 0 0 0 0 0 0 0
0 0 0 0 0 0 0 0 0 0 0
0 0 0 0 0 0 0 0 0 0 0
0 0 0 0 0 0 0 0 0 0 0
0 0 0 0 0 0 0 0 0 0 0
0 0 0 0 0 0 0 0 0 0 0
0 0 0 0 0 0 0 0 0 0 0
0 0 0 0 0 0 0 0 0 0 0
0 0 0 0 0 0 0 0 0 0 0
0 0 0 0 0 0 0 0 0 0 0
0 0 0 0 0 0 0 0 0 0 0
0 0 0 0 0 0 0 0 0 0 0
0 0 0 0 0 0 0 0 0 0 0
0 0 0 0 0 0 0 0 0 0 0
0 0 0 0 0 0 0 0 0 0 0
0 0 0 0 0 0 0 0 0 0 0
0 0 0 0 0 0 0 0 0 0 0
0 0 0 0 0 0 0 0 0 0 0
0 0 0 0 0 0 0 0 0 0 0
0 0 0 0 0 0 0 0 0 0 0
0 0 0 0 0 0 0 0 0 0 0
0 0 0 0 0 0 0 0 0 0 0
0 0 0 0 0 0 0 0 0 0 0
0 0 0 0 0 0 0 0 0 0 0