MODE 2
SIZE 11/70
LIMIT 0/40
COLOR LIMIT 4
STARS 2000/4200/7400
POWERUPS 1/0/0/0
1 1 1 1 1 17 1 1 1 1 1
3 7 3 20 20 20 20 3 7 3 0
17 3 11 3 20 8 20 3 14 3 17
17 3 3 3 20 20 3 3 3 17 0
7 7 7 7 7 17 1 1 1 1 1
20 20 20 20 0 0 20 20 20 20 0
1 1 1 1 1 17 7 7 7 7 7
17 2 7 2 20 20 2 7 2 17 0
17 2 8 2 20 8 20 2 8 2 17
2 2 2 20 20 20 20 2 2 2 0
7 7 7 7 7 17 1 1 1 1 1
20 20 20 20 0 0 20 20 20 20 0
1 1 1 1 1 17 7 7 7 7 7
5 7 5 20 20 20 20 5 7 5 0
17 5 16 5 20 8 20 5 13 5 17
17 5 5 5 20 20 5 5 5 17 0
7 7 7 7 7 17 1 1 1 1 1
20 20 20 20 10 10 20 20 20 20 0
1 1 1 1 1 17 7 7 7 7 7
17 4 7 4 20 20 4 7 4 17 0
17 4 15 4 20 8 20 4 12 4 17
4 4 4 20 20 20 20 4 4 4 0
7 7 7 7 7 17 1 1 1 1 1
20 20 20 20 0 0 20 20 20 20 0
1 1 1 1 1 17 7 7 7 7 7
0 0 0 0 0 0 0 0 0 0 0
0 0 0 0 0 0 0 0 0 0 0
0 0 0 0 0 0 0 0 0 0 0
0 0 0 0 0 0 0 0 0 0 0
0 0 0 0 0 0 0 0 0 0 0
0 0 0 0 0 0 0 0 0 0 0
0 0 0 0 0 0 0 0 0 0 0
0 0 0 0 0 0 0 0 0 0 0
0 0 0 0 0 0 0 0 0 0 0
0 0 0 0 0 0 0 0 0 0 0
0 0 0 0 0 0 0 0 0 0 0
0 0 0 0 0 0 0 0 0 0 0
0 0 0 0 0 0 0 0 0 0 0
0 0 0 0 0 0 0 0 0 0 0
0 0 0 0 0 0 0 0 0 0 0
0 0 0 0 0 0 0 0 0 0 0
0 0 0 0 0 0 0 0 0 0 0
0 0 0 0 0 0 0 0 0 0 0
0 0 0 0 0 0 0 0 0 0 0
0 0 0 0 0 0 0 0 0 0 0
0 0 0 0 0 0 0 0 0 0 0
0 0 0 0 0 0 0 0 0 0 0
0 0 0 0 0 0 0 0 0 0 0
0 0 0 0 0 0 0 0 0 0 0
0 0 0 0 0 0 0 0 0 0 0
0 0 0 0 0 0 0 0 0 0 0
0 0 0 0 0 0 0 0 0 0 0
0 0 0 0 0 0 0 0 0 0 0
0 0 0 0 0 0 0 0 0 0 0
0 0 0 0 0 0 0 0 0 0 0
0 0 0 0 0 0 0 0 0 0 0
0 0 0 0 0 0 0 0 0 0 0
0 0 0 0 0 0 0 0 0 0 0
0 0 0 0 0 0 0 0 0 0 0
0 0 0 0 0 0 0 0 0 0 0
0 0 0 0 0 0 0 0 0 0 0
0 0 0 0 0 0 0 0 0 0 0
0 0 0 0 0 0 0 0 0 0 0
0 0 0 0 0 0 0 0 0 0 0
0 0 0 0 0 0 0 0 0 0 0
0 0 0 0 0 0 0 0 0 0 0
0 0 0 0 0 0 0 0 0 0 0
0 0 0 0 0 0 0 0 0 0 0
0 0 0 0 0 0 0 0 0 0 0
0 0 0 0 0 0 0 0 0 0 0