MODE 2
SIZE 11/70
LIMIT 0/35
COLOR LIMIT 4
STARS 2000/4200/7400
POWERUPS 1/0/0/0
0 0 7 7 7 7 7 7 7 0 0
7 7 1 7 7 7 7 7 7 7 7
7 7 1 17 7 7 7 7 7 7 7
0 1 13 1 0 17 0 2 0 0 0
0 0 1 1 0 17 0 17 2 0 0
7 7 1 7 7 7 2 11 2 7 7
7 7 7 7 7 7 7 2 2 7 7
0 0 0 0 17 0 0 2 0 0 0
20 20 20 3 20 20 20 20 20 20 20
0 0 3 17 0 17 0 0 4 0 0
7 7 3 12 3 7 7 7 17 4 7
7 7 3 3 7 7 7 4 15 4 7
0 0 0 3 0 17 0 0 4 4 0
20 20 20 20 20 20 20 20 4 0 0
0 0 0 0 0 5 17 0 0 20 20
7 7 7 7 5 17 7 7 7 7 7
7 7 7 7 5 16 5 7 7 6 7
0 0 0 17 5 5 0 0 17 6 0
20 20 20 20 20 5 20 20 6 14 6
0 0 0 0 0 17 0 0 6 6 0
7 7 7 7 7 7 7 7 7 6 7
7 7 7 7 7 7 7 7 7 7 7
0 0 0 0 0 0 0 0 0 0 0
0 0 0 0 0 0 0 0 0 0 0
0 0 0 0 0 0 0 0 0 0 0
0 0 0 0 0 0 0 0 0 0 0
0 0 0 0 0 0 0 0 0 0 0
0 0 0 0 0 0 0 0 0 0 0
0 0 0 0 0 0 0 0 0 0 0
0 0 0 0 0 0 0 0 0 0 0
0 0 0 0 0 0 0 0 0 0 0
0 0 0 0 0 0 0 0 0 0 0
0 0 0 0 0 0 0 0 0 0 0
0 0 0 0 0 0 0 0 0 0 0
0 0 0 0 0 0 0 0 0 0 0
0 0 0 0 0 0 0 0 0 0 0
0 0 0 0 0 0 0 0 0 0 0
0 0 0 0 0 0 0 0 0 0 0
0 0 0 0 0 0 0 0 0 0 0
0 0 0 0 0 0 0 0 0 0 0
0 0 0 0 0 0 0 0 0 0 0
0 0 0 0 0 0 0 0 0 0 0
0 0 0 0 0 0 0 0 0 0 0
0 0 0 0 0 0 0 0 0 0 0
0 0 0 0 0 0 0 0 0 0 0
0 0 0 0 0 0 0 0 0 0 0
0 0 0 0 0 0 0 0 0 0 0
0 0 0 0 0 0 0 0 0 0 0
0 0 0 0 0 0 0 0 0 0 0
0 0 0 0 0 0 0 0 0 0 0
0 0 0 0 0 0 0 0 0 0 0
0 0 0 0 0 0 0 0 0 0 0
0 0 0 0 0 0 0 0 0 0 0
0 0 0 0 0 0 0 0 0 0 0
0 0 0 0 0 0 0 0 0 0 0
0 0 0 0 0 0 0 0 0 0 0
0 0 0 0 0 0 0 0 0 0 0
0 0 0 0 0 0 0 0 0 0 0
0 0 0 0 0 0 0 0 0 0 0
0 0 0 0 0 0 0 0 0 0 0
0 0 0 0 0 0 0 0 0 0 0
0 0 0 0 0 0 0 0 0 0 0
0 0 0 0 0 0 0 0 0 0 0
0 0 0 0 0 0 0 0 0 0 0
0 0 0 0 0 0 0 0 0 0 0
0 0 0 0 0 0 0 0 0 0 0
0 0 0 0 0 0 0 0 0 0 0
0 0 0 0 0 0 0 0 0 0 0
0 0 0 0 0 0 0 0 0 0 0
0 0 0 0 0 0 0 0 0 0 0