MODE 2
SIZE 11/70
LIMIT 0/45
COLOR LIMIT 4
STARS 1500/3200/5800
POWERUPS 0/1/0/0
1 1 1 1 2 11 2 1 1 1 1
0 0 5 2 7 7 2 5 0 0 0
0 0 5 2 7 17 7 2 5 0 0
0 17 20 7 2 2 7 20 17 0 0
0 5 2 7 2 20 2 7 2 5 0
5 2 7 2 20 20 2 7 2 5 0
5 2 2 20 20 7 20 20 2 2 5
3 3 3 20 7 7 20 3 3 3 0
0 0 0 20 7 13 7 20 0 0 0
0 0 1 20 7 7 20 1 0 0 0
0 0 1 18 20 20 20 18 1 0 0
0 6 1 1 3 3 1 1 6 0 0
0 0 6 6 20 20 20 6 6 0 0
0 6 20 20 5 5 20 20 6 0 0
0 17 20 2 2 18 2 2 20 17 0
6 20 3 3 18 18 3 3 20 6 0
6 20 1 1 18 10 18 1 1 20 6
0 0 0 18 5 5 18 0 0 0 0
3 3 3 3 18 18 18 3 3 3 3
5 5 5 2 5 5 2 5 5 5 5
17 17 17 2 0 0 0 2 17 17 17
2 2 2 20 7 7 20 2 2 2 2
17 20 20 20 7 8 7 20 20 20 17
0 0 0 0 7 7 0 0 0 0 0
0 0 0 0 0 0 0 0 0 0 0
0 0 0 0 0 0 0 0 0 0 0
0 0 0 0 0 0 0 0 0 0 0
0 0 0 0 0 0 0 0 0 0 0
0 0 0 0 0 0 0 0 0 0 0
0 0 0 0 0 0 0 0 0 0 0
0 0 0 0 0 0 0 0 0 0 0
0 0 0 0 0 0 0 0 0 0 0
0 0 0 0 0 0 0 0 0 0 0
0 0 0 0 0 0 0 0 0 0 0
0 0 0 0 0 0 0 0 0 0 0
0 0 0 0 0 0 0 0 0 0 0
0 0 0 0 0 0 0 0 0 0 0
0 0 0 0 0 0 0 0 0 0 0
0 0 0 0 0 0 0 0 0 0 0
0 0 0 0 0 0 0 0 0 0 0
0 0 0 0 0 0 0 0 0 0 0
0 0 0 0 0 0 0 0 0 0 0
0 0 0 0 0 0 0 0 0 0 0
0 0 0 0 0 0 0 0 0 0 0
0 0 0 0 0 0 0 0 0 0 0
0 0 0 0 0 0 0 0 0 0 0
0 0 0 0 0 0 0 0 0 0 0
0 0 0 0 0 0 0 0 0 0 0
0 0 0 0 0 0 0 0 0 0 0
0 0 0 0 0 0 0 0 0 0 0
0 0 0 0 0 0 0 0 0 0 0
0 0 0 0 0 0 0 0 0 0 0
0 0 0 0 0 0 0 0 0 0 0
0 0 0 0 0 0 0 0 0 0 0
0 0 0 0 0 0 0 0 0 0 0
0 0 0 0 0 0 0 0 0 0 0
0 0 0 0 0 0 0 0 0 0 0
0 0 0 0 0 0 0 0 0 0 0
0 0 0 0 0 0 0 0 0 0 0
0 0 0 0 0 0 0 0 0 0 0
0 0 0 0 0 0 0 0 0 0 0
0 0 0 0 0 0 0 0 0 0 0
0 0 0 0 0 0 0 0 0 0 0
0 0 0 0 0 0 0 0 0 0 0
0 0 0 0 0 0 0 0 0 0 0
0 0 0 0 0 0 0 0 0 0 0
0 0 0 0 0 0 0 0 0 0 0
0 0 0 0 0 0 0 0 0 0 0
0 0 0 0 0 0 0 0 0 0 0
0 0 0 0 0 0 0 0 0 0 0