MODE 2
SIZE 11/70
LIMIT 0/50
COLOR LIMIT 4
STARS 1500/3200/5600
POWERUPS 0/1/0/0
1 1 1 1 20 20 20 1 1 1 1
3 20 20 20 1 1 20 20 20 3 0
4 3 20 5 5 14 5 5 20 3 4
4 5 20 2 2 2 2 20 5 4 0
19 4 3 18 18 11 18 18 3 4 19
19 18 3 6 6 6 6 3 18 19 0
17 20 18 3 18 13 18 3 18 20 17
0 20 4 3 18 18 3 4 20 0 0
0 0 20 5 5 5 5 5 20 0 0
0 4 20 20 20 20 20 20 4 0 0
0 4 20 3 3 11 3 3 20 4 0
4 20 3 1 18 18 1 3 20 4 0
4 0 3 1 18 20 18 1 3 0 4
1 1 1 18 5 20 18 1 1 1 0
18 18 18 3 5 13 5 3 18 18 18
20 20 18 3 5 5 3 18 20 20 0
0 0 20 18 3 20 3 18 20 0 0
7 0 20 20 3 3 20 20 0 7 0
0 7 7 7 7 3 7 7 7 7 0
7 7 7 7 7 7 7 7 7 7 0
7 0 0 7 7 17 7 7 0 0 7
0 0 0 7 7 7 7 0 0 0 0
0 0 0 0 0 0 0 0 0 0 0
0 0 0 0 0 0 0 0 0 0 0
0 0 0 0 0 0 0 0 0 0 0
0 0 0 0 0 0 0 0 0 0 0
0 0 0 0 0 0 0 0 0 0 0
0 0 0 0 0 0 0 0 0 0 0
0 0 0 0 0 0 0 0 0 0 0
0 0 0 0 0 0 0 0 0 0 0
0 0 0 0 0 0 0 0 0 0 0
0 0 0 0 0 0 0 0 0 0 0
0 0 0 0 0 0 0 0 0 0 0
0 0 0 0 0 0 0 0 0 0 0
0 0 0 0 0 0 0 0 0 0 0
0 0 0 0 0 0 0 0 0 0 0
0 0 0 0 0 0 0 0 0 0 0
0 0 0 0 0 0 0 0 0 0 0
0 0 0 0 0 0 0 0 0 0 0
0 0 0 0 0 0 0 0 0 0 0
0 0 0 0 0 0 0 0 0 0 0
0 0 0 0 0 0 0 0 0 0 0
0 0 0 0 0 0 0 0 0 0 0
0 0 0 0 0 0 0 0 0 0 0
0 0 0 0 0 0 0 0 0 0 0
0 0 0 0 0 0 0 0 0 0 0
0 0 0 0 0 0 0 0 0 0 0
0 0 0 0 0 0 0 0 0 0 0
0 0 0 0 0 0 0 0 0 0 0
0 0 0 0 0 0 0 0 0 0 0
0 0 0 0 0 0 0 0 0 0 0
0 0 0 0 0 0 0 0 0 0 0
0 0 0 0 0 0 0 0 0 0 0
0 0 0 0 0 0 0 0 0 0 0
0 0 0 0 0 0 0 0 0 0 0
0 0 0 0 0 0 0 0 0 0 0
0 0 0 0 0 0 0 0 0 0 0
0 0 0 0 0 0 0 0 0 0 0
0 0 0 0 0 0 0 0 0 0 0
0 0 0 0 0 0 0 0 0 0 0
0 0 0 0 0 0 0 0 0 0 0
0 0 0 0 0 0 0 0 0 0 0
0 0 0 0 0 0 0 0 0 0 0
0 0 0 0 0 0 0 0 0 0 0
0 0 0 0 0 0 0 0 0 0 0
0 0 0 0 0 0 0 0 0 0 0
0 0 0 0 0 0 0 0 0 0 0
0 0 0 0 0 0 0 0 0 0 0
0 0 0 0 0 0 0 0 0 0 0
0 0 0 0 0 0 0 0 0 0 0