MODE 2
SIZE 11/70
LIMIT 0/45
COLOR LIMIT 4
STARS 1100/2100/4300
POWERUPS 0/1/0/0
6 5 5 1 5 14 3 5 5 4 5
0 0 1 0 0 3 0 0 4 0 0
0 0 1 0 0 3 0 0 4 0 0
0 17 0 0 17 0 0 17 0 0 17
0 1 0 0 3 0 0 4 0 0 6
1 0 0 3 0 0 4 0 0 6 0
1 5 5 3 5 5 4 5 5 6 5
20 20 20 20 20 11 20 20 20 20 20
5 5 2 5 5 3 5 5 6 5 5
0 2 0 0 3 0 0 6 0 0 4
0 2 0 0 3 0 0 6 0 0 4
17 0 0 17 0 0 17 0 0 17 0
2 0 0 3 0 0 6 0 0 4 0
0 0 3 0 0 6 0 0 4 0 0
5 5 3 5 5 6 5 5 4 5 5
20 20 20 20 20 12 20 20 20 20 20
5 5 5 1 5 5 3 5 5 2 5
0 0 1 0 0 3 0 0 2 0 0
0 0 1 0 0 3 0 0 2 0 0
0 17 0 0 17 0 0 17 0 0 17
0 1 0 0 3 0 0 2 0 0 6
1 0 0 3 0 0 2 0 0 6 0
1 5 5 3 5 5 2 5 5 6 5
20 20 20 20 20 13 20 20 20 20 20
0 0 0 0 0 0 0 0 0 0 0
0 0 0 0 0 0 0 0 0 0 0
0 0 0 0 0 0 0 0 0 0 0
0 0 0 0 0 0 0 0 0 0 0
0 0 0 0 0 0 0 0 0 0 0
0 0 0 0 0 0 0 0 0 0 0
0 0 0 0 0 0 0 0 0 0 0
0 0 0 0 0 0 0 0 0 0 0
0 0 0 0 0 0 0 0 0 0 0
0 0 0 0 0 0 0 0 0 0 0
0 0 0 0 0 0 0 0 0 0 0
0 0 0 0 0 0 0 0 0 0 0
0 0 0 0 0 0 0 0 0 0 0
0 0 0 0 0 0 0 0 0 0 0
0 0 0 0 0 0 0 0 0 0 0
0 0 0 0 0 0 0 0 0 0 0
0 0 0 0 0 0 0 0 0 0 0
0 0 0 0 0 0 0 0 0 0 0
0 0 0 0 0 0 0 0 0 0 0
0 0 0 0 0 0 0 0 0 0 0
0 0 0 0 0 0 0 0 0 0 0
0 0 0 0 0 0 0 0 0 0 0
0 0 0 0 0 0 0 0 0 0 0
0 0 0 0 0 0 0 0 0 0 0
0 0 0 0 0 0 0 0 0 0 0
0 0 0 0 0 0 0 0 0 0 0
0 0 0 0 0 0 0 0 0 0 0
0 0 0 0 0 0 0 0 0 0 0
0 0 0 0 0 0 0 0 0 0 0
0 0 0 0 0 0 0 0 0 0 0
0 0 0 0 0 0 0 0 0 0 0
0 0 0 0 0 0 0 0 0 0 0
0 0 0 0 0 0 0 0 0 0 0
0 0 0 0 0 0 0 0 0 0 0
0 0 0 0 0 0 0 0 0 0 0
0 0 0 0 0 0 0 0 0 0 0
0 0 0 0 0 0 0 0 0 0 0
0 0 0 0 0 0 0 0 0 0 0
0 0 0 0 0 0 0 0 0 0 0
0 0 0 0 0 0 0 0 0 0 0
0 0 0 0 0 0 0 0 0 0 0
0 0 0 0 0 0 0 0 0 0 0
0 0 0 0 0 0 0 0 0 0 0
0 0 0 0 0 0 0 0 0 0 0
0 0 0 0 0 0 0 0 0 0 0
0 0 0 0 0 0 0 0 0 0 0