MODE 2
SIZE 11/70
LIMIT 0/40
COLOR LIMIT 4
STARS 3500/7000/11000
POWERUPS 1/0/0/0
1 20 17 1 1 17 1 1 17 20 1
20 3 3 1 20 3 3 1 20 1 1
18 18 12 3 18 3 11 18 18 18 18
1 3 3 20 1 3 3 20 1 1 1
1 1 1 20 8 1 1 20 1 1 1
1 1 20 3 3 1 20 1 3 3 20
18 18 18 18 14 3 18 18 18 12 3
1 20 1 3 3 20 1 1 3 3 1
1 3 3 1 1 20 1 1 1 20 1
3 16 3 1 20 3 3 1 20 1 1
18 18 3 18 18 3 8 18 18 18 18
1 1 1 20 1 3 3 20 1 1 1
1 1 3 3 1 1 1 20 1 3 3
1 3 7 3 1 9 20 1 3 1 3
1 1 3 18 1 1 20 1 1 3 3
18 18 18 18 3 3 18 18 18 18 18
1 3 18 1 3 7 18 1 1 20 1
3 7 3 8 3 3 1 1 3 3 1
20 3 3 1 20 1 1 1 3 15 3
1 1 1 20 1 1 1 20 18 3 1
1 1 18 20 1 18 1 20 18 1 1
0 0 0 0 0 0 0 0 0 0 0
0 0 0 0 0 0 0 0 0 0 0
0 0 0 0 0 0 0 0 0 0 0
0 0 0 0 0 0 0 0 0 0 0
0 0 0 0 0 0 0 0 0 0 0
0 0 0 0 0 0 0 0 0 0 0
0 0 0 0 0 0 0 0 0 0 0
0 0 0 0 0 0 0 0 0 0 0
0 0 0 0 0 0 0 0 0 0 0
0 0 0 0 0 0 0 0 0 0 0
0 0 0 0 0 0 0 0 0 0 0
0 0 0 0 0 0 0 0 0 0 0
0 0 0 0 0 0 0 0 0 0 0
0 0 0 0 0 0 0 0 0 0 0
0 0 0 0 0 0 0 0 0 0 0
0 0 0 0 0 0 0 0 0 0 0
0 0 0 0 0 0 0 0 0 0 0
0 0 0 0 0 0 0 0 0 0 0
0 0 0 0 0 0 0 0 0 0 0
0 0 0 0 0 0 0 0 0 0 0
0 0 0 0 0 0 0 0 0 0 0
0 0 0 0 0 0 0 0 0 0 0
0 0 0 0 0 0 0 0 0 0 0
0 0 0 0 0 0 0 0 0 0 0
0 0 0 0 0 0 0 0 0 0 0
0 0 0 0 0 0 0 0 0 0 0
0 0 0 0 0 0 0 0 0 0 0
0 0 0 0 0 0 0 0 0 0 0
0 0 0 0 0 0 0 0 0 0 0
0 0 0 0 0 0 0 0 0 0 0
0 0 0 0 0 0 0 0 0 0 0
0 0 0 0 0 0 0 0 0 0 0
0 0 0 0 0 0 0 0 0 0 0
0 0 0 0 0 0 0 0 0 0 0
0 0 0 0 0 0 0 0 0 0 0
0 0 0 0 0 0 0 0 0 0 0
0 0 0 0 0 0 0 0 0 0 0
0 0 0 0 0 0 0 0 0 0 0
0 0 0 0 0 0 0 0 0 0 0
0 0 0 0 0 0 0 0 0 0 0
0 0 0 0 0 0 0 0 0 0 0
0 0 0 0 0 0 0 0 0 0 0
0 0 0 0 0 0 0 0 0 0 0
0 0 0 0 0 0 0 0 0 0 0
0 0 0 0 0 0 0 0 0 0 0
0 0 0 0 0 0 0 0 0 0 0
0 0 0 0 0 0 0 0 0 0 0
0 0 0 0 0 0 0 0 0 0 0
0 0 0 0 0 0 0 0 0 0 0