MODE 2
SIZE 11/70
LIMIT 0/45
COLOR LIMIT 4
STARS 3200/4200/7200
POWERUPS 1/1/0/0
4 4 14 4 5 5 5 4 14 4 4
3 3 4 1 5 5 1 4 3 3 3
2 2 3 4 1 5 1 4 3 2 2
6 5 3 2 1 1 2 3 5 11 4
4 6 5 3 14 1 2 3 5 6 4
6 5 3 7 1 1 7 3 5 6 4
6 5 3 7 1 4 1 7 3 5 6
5 3 7 1 4 4 1 7 3 14 6
3 2 7 5 1 18 1 5 7 2 3
3 7 17 5 1 1 5 6 17 3 5
5 7 7 6 18 1 18 6 7 3 5
5 20 7 6 5 5 6 7 20 5 0
0 18 3 7 6 5 6 7 3 18 0
0 5 3 7 7 6 7 3 5 0 0
0 0 5 7 7 20 7 7 5 0 0
0 2 5 3 18 18 3 5 2 0 0
0 2 2 5 3 2 3 5 2 2 0
2 1 1 5 3 3 5 1 1 2 0
2 1 1 1 5 3 5 1 1 1 2
2 1 1 2 5 5 2 1 1 2 0
0 2 2 2 0 5 0 2 2 2 0
0 0 0 0 0 0 0 0 0 0 0
0 0 0 0 0 0 0 0 0 0 0
0 0 0 0 0 0 0 0 0 0 0
0 0 0 0 0 0 0 0 0 0 0
0 0 0 0 0 0 0 0 0 0 0
0 0 0 0 0 0 0 0 0 0 0
0 0 0 0 0 0 0 0 0 0 0
0 0 0 0 0 0 0 0 0 0 0
0 0 0 0 0 0 0 0 0 0 0
0 0 0 0 0 0 0 0 0 0 0
0 0 0 0 0 0 0 0 0 0 0
0 0 0 0 0 0 0 0 0 0 0
0 0 0 0 0 0 0 0 0 0 0
0 0 0 0 0 0 0 0 0 0 0
0 0 0 0 0 0 0 0 0 0 0
0 0 0 0 0 0 0 0 0 0 0
0 0 0 0 0 0 0 0 0 0 0
0 0 0 0 0 0 0 0 0 0 0
0 0 0 0 0 0 0 0 0 0 0
0 0 0 0 0 0 0 0 0 0 0
0 0 0 0 0 0 0 0 0 0 0
0 0 0 0 0 0 0 0 0 0 0
0 0 0 0 0 0 0 0 0 0 0
0 0 0 0 0 0 0 0 0 0 0
0 0 0 0 0 0 0 0 0 0 0
0 0 0 0 0 0 0 0 0 0 0
0 0 0 0 0 0 0 0 0 0 0
0 0 0 0 0 0 0 0 0 0 0
0 0 0 0 0 0 0 0 0 0 0
0 0 0 0 0 0 0 0 0 0 0
0 0 0 0 0 0 0 0 0 0 0
0 0 0 0 0 0 0 0 0 0 0
0 0 0 0 0 0 0 0 0 0 0
0 0 0 0 0 0 0 0 0 0 0
0 0 0 0 0 0 0 0 0 0 0
0 0 0 0 0 0 0 0 0 0 0
0 0 0 0 0 0 0 0 0 0 0
0 0 0 0 0 0 0 0 0 0 0
0 0 0 0 0 0 0 0 0 0 0
0 0 0 0 0 0 0 0 0 0 0
0 0 0 0 0 0 0 0 0 0 0
0 0 0 0 0 0 0 0 0 0 0
0 0 0 0 0 0 0 0 0 0 0
0 0 0 0 0 0 0 0 0 0 0
0 0 0 0 0 0 0 0 0 0 0
0 0 0 0 0 0 0 0 0 0 0
0 0 0 0 0 0 0 0 0 0 0
0 0 0 0 0 0 0 0 0 0 0
0 0 0 0 0 0 0 0 0 0 0