MODE 2
SIZE 11/70
LIMIT 0/30
COLOR LIMIT 4
STARS 3200/5200/7200
POWERUPS 0/0/0/0
0 3 3 3 20 20 20 3 3 3 0
0 3 3 2 13 3 12 3 3 0 0
0 0 20 2 3 3 3 20 3 0 0
0 3 3 2 3 3 2 3 3 0 0
0 13 3 3 2 2 2 3 3 13 0
6 6 6 6 20 20 6 6 6 6 0
0 6 6 6 1 3 1 6 6 6 0
0 6 6 1 3 3 1 6 6 0 0
0 0 20 1 3 3 3 1 20 0 0
0 6 6 1 3 3 1 6 6 0 0
0 6 6 6 1 3 1 6 6 6 0
6 6 6 6 1 1 6 6 6 6 0
0 4 4 4 20 20 20 4 4 4 0
0 4 4 2 3 3 12 4 4 0 0
0 0 20 2 3 3 3 2 20 0 0
0 4 4 2 3 3 2 4 4 0 0
0 4 4 4 2 2 2 4 4 4 0
1 1 1 1 20 20 1 1 1 1 0
0 1 1 1 6 3 6 1 1 1 0
0 1 1 6 3 3 6 1 1 0 0
0 0 20 6 3 3 3 6 20 0 0
0 1 1 6 3 3 6 1 1 0 0
0 1 1 1 6 3 6 1 1 1 0
1 1 1 1 6 6 1 1 1 1 0
0 0 0 0 0 0 0 0 0 0 0
0 0 0 0 0 0 0 0 0 0 0
0 0 0 0 0 0 0 0 0 0 0
0 0 0 0 0 0 0 0 0 0 0
0 0 0 0 0 0 0 0 0 0 0
0 0 0 0 0 0 0 0 0 0 0
0 0 0 0 0 0 0 0 0 0 0
0 0 0 0 0 0 0 0 0 0 0
0 0 0 0 0 0 0 0 0 0 0
0 0 0 0 0 0 0 0 0 0 0
0 0 0 0 0 0 0 0 0 0 0
0 0 0 0 0 0 0 0 0 0 0
0 0 0 0 0 0 0 0 0 0 0
0 0 0 0 0 0 0 0 0 0 0
0 0 0 0 0 0 0 0 0 0 0
0 0 0 0 0 0 0 0 0 0 0
0 0 0 0 0 0 0 0 0 0 0
0 0 0 0 0 0 0 0 0 0 0
0 0 0 0 0 0 0 0 0 0 0
0 0 0 0 0 0 0 0 0 0 0
0 0 0 0 0 0 0 0 0 0 0
0 0 0 0 0 0 0 0 0 0 0
0 0 0 0 0 0 0 0 0 0 0
0 0 0 0 0 0 0 0 0 0 0
0 0 0 0 0 0 0 0 0 0 0
0 0 0 0 0 0 0 0 0 0 0
0 0 0 0 0 0 0 0 0 0 0
0 0 0 0 0 0 0 0 0 0 0
0 0 0 0 0 0 0 0 0 0 0
0 0 0 0 0 0 0 0 0 0 0
0 0 0 0 0 0 0 0 0 0 0
0 0 0 0 0 0 0 0 0 0 0
0 0 0 0 0 0 0 0 0 0 0
0 0 0 0 0 0 0 0 0 0 0
0 0 0 0 0 0 0 0 0 0 0
0 0 0 0 0 0 0 0 0 0 0
0 0 0 0 0 0 0 0 0 0 0
0 0 0 0 0 0 0 0 0 0 0
0 0 0 0 0 0 0 0 0 0 0
0 0 0 0 0 0 0 0 0 0 0
0 0 0 0 0 0 0 0 0 0 0
0 0 0 0 0 0 0 0 0 0 0
0 0 0 0 0 0 0 0 0 0 0
0 0 0 0 0 0 0 0 0 0 0
0 0 0 0 0 0 0 0 0 0 0
0 0 0 0 0 0 0 0 0 0 0