MODE 2
SIZE 11/70
LIMIT 0/30
COLOR LIMIT 4
STARS 3200/5200/7200
POWERUPS 0/0/0/0
0 4 4 0 0 4 4 0 0 4 4
4 4 4 0 4 4 4 0 4 4 4
0 4 4 11 1 4 4 1 1 14 4
0 0 1 1 1 0 1 1 1 0 0
0 3 3 1 1 3 3 1 1 3 3
3 3 3 0 3 3 3 0 3 3 3
0 3 3 6 6 3 3 6 6 3 3
0 0 6 6 6 0 6 6 6 0 0
0 2 2 6 6 2 2 6 6 2 2
2 2 2 0 2 2 2 0 2 2 2
0 2 2 5 15 2 2 5 5 2 2
0 0 5 5 5 0 5 5 5 0 0
0 4 14 5 5 4 4 5 5 4 4
4 4 4 0 4 4 4 0 4 4 4
0 4 4 1 1 4 4 1 11 4 4
0 0 1 1 1 0 1 1 1 0 0
0 3 3 1 1 3 3 1 1 3 3
3 3 3 0 3 3 3 0 3 3 3
0 3 3 6 6 3 3 6 6 3 3
0 0 6 6 6 0 6 6 6 0 0
0 2 2 6 6 2 2 6 6 2 2
2 2 2 0 2 2 2 0 2 2 2
0 2 2 0 0 2 2 0 0 2 2
0 0 0 0 0 0 0 0 0 0 0
0 0 0 0 0 0 0 0 0 0 0
0 0 0 0 0 0 0 0 0 0 0
0 0 0 0 0 0 0 0 0 0 0
0 0 0 0 0 0 0 0 0 0 0
0 0 0 0 0 0 0 0 0 0 0
0 0 0 0 0 0 0 0 0 0 0
0 0 0 0 0 0 0 0 0 0 0
0 0 0 0 0 0 0 0 0 0 0
0 0 0 0 0 0 0 0 0 0 0
0 0 0 0 0 0 0 0 0 0 0
0 0 0 0 0 0 0 0 0 0 0
0 0 0 0 0 0 0 0 0 0 0
0 0 0 0 0 0 0 0 0 0 0
0 0 0 0 0 0 0 0 0 0 0
0 0 0 0 0 0 0 0 0 0 0
0 0 0 0 0 0 0 0 0 0 0
0 0 0 0 0 0 0 0 0 0 0
0 0 0 0 0 0 0 0 0 0 0
0 0 0 0 0 0 0 0 0 0 0
0 0 0 0 0 0 0 0 0 0 0
0 0 0 0 0 0 0 0 0 0 0
0 0 0 0 0 0 0 0 0 0 0
0 0 0 0 0 0 0 0 0 0 0
0 0 0 0 0 0 0 0 0 0 0
0 0 0 0 0 0 0 0 0 0 0
0 0 0 0 0 0 0 0 0 0 0
0 0 0 0 0 0 0 0 0 0 0
0 0 0 0 0 0 0 0 0 0 0
0 0 0 0 0 0 0 0 0 0 0
0 0 0 0 0 0 0 0 0 0 0
0 0 0 0 0 0 0 0 0 0 0
0 0 0 0 0 0 0 0 0 0 0
0 0 0 0 0 0 0 0 0 0 0
0 0 0 0 0 0 0 0 0 0 0
0 0 0 0 0 0 0 0 0 0 0
0 0 0 0 0 0 0 0 0 0 0
0 0 0 0 0 0 0 0 0 0 0
0 0 0 0 0 0 0 0 0 0 0
0 0 0 0 0 0 0 0 0 0 0
0 0 0 0 0 0 0 0 0 0 0
0 0 0 0 0 0 0 0 0 0 0
0 0 0 0 0 0 0 0 0 0 0
0 0 0 0 0 0 0 0 0 0 0
0 0 0 0 0 0 0 0 0 0 0
0 0 0 0 0 0 0 0 0 0 0
0 0 0 0 0 0 0 0 0 0 0