MODE 2
SIZE 11/70
LIMIT 0/20
COLOR LIMIT 4
STARS 3200/5200/7200
POWERUPS 0/0/0/0
1 1 1 0 1 1 1 0 1 1 1
1 1 0 0 1 1 0 0 1 1 0
0 11 0 0 0 11 0 0 0 11 0
0 4 4 4 0 4 4 4 0 4 4
0 0 4 4 0 0 4 4 0 0 4
0 0 14 0 0 0 14 0 0 0 14
6 6 6 0 6 6 6 0 6 6 6
6 6 0 0 6 6 0 0 6 6 0
0 6 0 0 0 6 0 0 0 6 0
0 3 3 3 0 3 3 3 0 3 3
0 0 3 3 0 0 3 3 0 0 3
0 0 3 0 0 0 3 0 0 0 3
2 2 2 0 2 2 2 0 2 2 2
2 2 0 0 2 2 0 0 2 2 0
0 2 0 0 0 2 0 0 0 2 0
0 5 5 5 0 5 5 5 0 5 5
0 0 5 5 0 0 5 5 0 0 5
0 0 5 0 0 0 5 0 0 0 5
1 1 1 0 1 1 1 0 1 1 1
1 1 0 0 1 1 0 0 1 1 0
0 1 0 0 0 1 0 0 0 1 0
0 4 4 4 0 4 4 4 0 4 4
0 0 4 4 0 0 4 4 0 0 4
0 0 4 0 0 0 4 0 0 0 4
6 6 6 0 6 6 6 0 6 6 6
6 6 0 0 6 6 0 0 6 6 0
0 6 0 0 0 6 0 0 0 6 0
0 0 0 0 0 0 0 0 0 0 0
0 0 0 0 0 0 0 0 0 0 0
0 0 0 0 0 0 0 0 0 0 0
0 0 0 0 0 0 0 0 0 0 0
0 0 0 0 0 0 0 0 0 0 0
0 0 0 0 0 0 0 0 0 0 0
0 0 0 0 0 0 0 0 0 0 0
0 0 0 0 0 0 0 0 0 0 0
0 0 0 0 0 0 0 0 0 0 0
0 0 0 0 0 0 0 0 0 0 0
0 0 0 0 0 0 0 0 0 0 0
0 0 0 0 0 0 0 0 0 0 0
0 0 0 0 0 0 0 0 0 0 0
0 0 0 0 0 0 0 0 0 0 0
0 0 0 0 0 0 0 0 0 0 0
0 0 0 0 0 0 0 0 0 0 0
0 0 0 0 0 0 0 0 0 0 0
0 0 0 0 0 0 0 0 0 0 0
0 0 0 0 0 0 0 0 0 0 0
0 0 0 0 0 0 0 0 0 0 0
0 0 0 0 0 0 0 0 0 0 0
0 0 0 0 0 0 0 0 0 0 0
0 0 0 0 0 0 0 0 0 0 0
0 0 0 0 0 0 0 0 0 0 0
0 0 0 0 0 0 0 0 0 0 0
0 0 0 0 0 0 0 0 0 0 0
0 0 0 0 0 0 0 0 0 0 0
0 0 0 0 0 0 0 0 0 0 0
0 0 0 0 0 0 0 0 0 0 0
0 0 0 0 0 0 0 0 0 0 0
0 0 0 0 0 0 0 0 0 0 0
0 0 0 0 0 0 0 0 0 0 0
0 0 0 0 0 0 0 0 0 0 0
0 0 0 0 0 0 0 0 0 0 0
0 0 0 0 0 0 0 0 0 0 0
0 0 0 0 0 0 0 0 0 0 0
0 0 0 0 0 0 0 0 0 0 0
0 0 0 0 0 0 0 0 0 0 0
0 0 0 0 0 0 0 0 0 0 0
0 0 0 0 0 0 0 0 0 0 0
0 0 0 0 0 0 0 0 0 0 0
0 0 0 0 0 0 0 0 0 0 0
0 0 0 0 0 0 0 0 0 0 0