MODE 2
SIZE 11/70
LIMIT 0/40
COLOR LIMIT 4
STARS 3200/5200/7200
POWERUPS 0/0/1/0
6 4 4 6 6 4 4 6 6 4 4
4 14 4 6 4 14 4 6 4 14 4
6 4 4 6 6 4 4 6 6 4 4
1 1 3 3 1 1 3 3 1 1 3
1 1 1 3 1 1 1 3 1 1 1
1 1 3 3 1 1 3 3 1 1 3
5 2 2 5 5 2 2 5 5 2 2
2 2 2 5 2 2 2 5 2 2 2
5 2 2 5 5 2 2 5 5 2 2
4 4 6 6 4 4 10 6 4 4 6
4 14 4 6 4 14 4 6 4 14 4
4 4 6 6 4 4 6 6 4 4 6
3 1 1 3 3 1 1 3 3 1 1
1 1 1 3 1 1 1 3 1 1 1
3 1 1 3 3 1 1 3 3 1 1
2 2 5 5 2 2 5 5 2 2 5
2 2 2 5 2 2 2 5 2 2 2
2 2 5 5 2 2 5 5 2 2 5
6 4 4 6 6 4 4 6 6 4 4
4 4 4 6 4 4 4 6 4 4 4
6 4 4 6 6 4 4 6 6 4 4
1 1 3 3 1 1 3 3 1 1 3
1 1 1 3 1 1 1 3 1 1 1
1 1 3 3 1 1 3 3 1 1 3
0 0 0 0 0 0 0 0 0 0 0
0 0 0 0 0 0 0 0 0 0 0
0 0 0 0 0 0 0 0 0 0 0
0 0 0 0 0 0 0 0 0 0 0
0 0 0 0 0 0 0 0 0 0 0
0 0 0 0 0 0 0 0 0 0 0
0 0 0 0 0 0 0 0 0 0 0
0 0 0 0 0 0 0 0 0 0 0
0 0 0 0 0 0 0 0 0 0 0
0 0 0 0 0 0 0 0 0 0 0
0 0 0 0 0 0 0 0 0 0 0
0 0 0 0 0 0 0 0 0 0 0
0 0 0 0 0 0 0 0 0 0 0
0 0 0 0 0 0 0 0 0 0 0
0 0 0 0 0 0 0 0 0 0 0
0 0 0 0 0 0 0 0 0 0 0
0 0 0 0 0 0 0 0 0 0 0
0 0 0 0 0 0 0 0 0 0 0
0 0 0 0 0 0 0 0 0 0 0
0 0 0 0 0 0 0 0 0 0 0
0 0 0 0 0 0 0 0 0 0 0
0 0 0 0 0 0 0 0 0 0 0
0 0 0 0 0 0 0 0 0 0 0
0 0 0 0 0 0 0 0 0 0 0
0 0 0 0 0 0 0 0 0 0 0
0 0 0 0 0 0 0 0 0 0 0
0 0 0 0 0 0 0 0 0 0 0
0 0 0 0 0 0 0 0 0 0 0
0 0 0 0 0 0 0 0 0 0 0
0 0 0 0 0 0 0 0 0 0 0
0 0 0 0 0 0 0 0 0 0 0
0 0 0 0 0 0 0 0 0 0 0
0 0 0 0 0 0 0 0 0 0 0
0 0 0 0 0 0 0 0 0 0 0
0 0 0 0 0 0 0 0 0 0 0
0 0 0 0 0 0 0 0 0 0 0
0 0 0 0 0 0 0 0 0 0 0
0 0 0 0 0 0 0 0 0 0 0
0 0 0 0 0 0 0 0 0 0 0
0 0 0 0 0 0 0 0 0 0 0
0 0 0 0 0 0 0 0 0 0 0
0 0 0 0 0 0 0 0 0 0 0
0 0 0 0 0 0 0 0 0 0 0
0 0 0 0 0 0 0 0 0 0 0
0 0 0 0 0 0 0 0 0 0 0
0 0 0 0 0 0 0 0 0 0 0