MODE 2
SIZE 11/70
LIMIT 0/25
COLOR LIMIT 4
STARS 2200/3200/5200
POWERUPS 0/0/0/0
20 20 20 20 20 20 20 20 20 20 20
0 16 16 0 0 0 0 0 16 16 0
4 4 4 4 4 4 4 4 4 4 4
0 0 5 5 0 6 0 5 5 0 0
0 0 5 0 5 6 6 5 0 5 0
20 20 5 5 0 6 0 5 5 20 20
2 2 2 2 2 2 2 2 2 2 2
0 0 1 1 0 4 0 1 1 0 0
0 0 1 0 1 4 4 1 0 1 0
20 20 1 1 0 4 0 1 1 20 20
3 3 3 3 3 3 3 3 3 3 3
0 0 6 6 0 2 0 6 6 0 0
0 0 6 0 6 2 2 6 0 6 0
20 20 6 6 0 2 0 6 6 20 20
4 4 4 4 4 4 4 4 4 4 4
0 0 5 5 0 1 0 5 5 0 0
0 0 5 0 5 1 1 5 0 5 0
20 20 5 5 0 1 0 5 5 20 20
2 2 2 2 2 2 2 2 2 2 2
0 0 1 1 0 6 0 1 1 0 0
0 0 1 0 1 6 6 1 0 1 0
20 20 1 1 0 6 0 1 1 20 20
3 3 3 3 3 3 3 3 3 3 3
0 0 6 6 0 1 0 6 6 0 0
0 0 6 0 6 1 1 6 0 6 0
20 20 6 6 0 1 0 6 6 20 20
4 4 4 4 4 20 20 4 4 4 4
0 0 0 0 0 0 0 0 0 0 0
0 0 0 0 0 0 0 0 0 0 0
0 0 0 0 0 0 0 0 0 0 0
0 0 0 0 0 0 0 0 0 0 0
0 0 0 0 0 0 0 0 0 0 0
0 0 0 0 0 0 0 0 0 0 0
0 0 0 0 0 0 0 0 0 0 0
0 0 0 0 0 0 0 0 0 0 0
0 0 0 0 0 0 0 0 0 0 0
0 0 0 0 0 0 0 0 0 0 0
0 0 0 0 0 0 0 0 0 0 0
0 0 0 0 0 0 0 0 0 0 0
0 0 0 0 0 0 0 0 0 0 0
0 0 0 0 0 0 0 0 0 0 0
0 0 0 0 0 0 0 0 0 0 0
0 0 0 0 0 0 0 0 0 0 0
0 0 0 0 0 0 0 0 0 0 0
0 0 0 0 0 0 0 0 0 0 0
0 0 0 0 0 0 0 0 0 0 0
0 0 0 0 0 0 0 0 0 0 0
0 0 0 0 0 0 0 0 0 0 0
0 0 0 0 0 0 0 0 0 0 0
0 0 0 0 0 0 0 0 0 0 0
0 0 0 0 0 0 0 0 0 0 0
0 0 0 0 0 0 0 0 0 0 0
0 0 0 0 0 0 0 0 0 0 0
0 0 0 0 0 0 0 0 0 0 0
0 0 0 0 0 0 0 0 0 0 0
0 0 0 0 0 0 0 0 0 0 0
0 0 0 0 0 0 0 0 0 0 0
0 0 0 0 0 0 0 0 0 0 0
0 0 0 0 0 0 0 0 0 0 0
0 0 0 0 0 0 0 0 0 0 0
0 0 0 0 0 0 0 0 0 0 0
0 0 0 0 0 0 0 0 0 0 0
0 0 0 0 0 0 0 0 0 0 0
0 0 0 0 0 0 0 0 0 0 0
0 0 0 0 0 0 0 0 0 0 0
0 0 0 0 0 0 0 0 0 0 0
0 0 0 0 0 0 0 0 0 0 0
0 0 0 0 0 0 0 0 0 0 0
0 0 0 0 0 0 0 0 0 0 0
0 0 0 0 0 0 0 0 0 0 0