MODE 2
SIZE 11/70
LIMIT 0/35
COLOR LIMIT 4
STARS 3200/5200/7200
POWERUPS 0/0/1/0
4 4 14 4 4 20 20 4 14 4 4
5 5 5 5 5 20 5 5 5 5 5
5 0 5 15 5 0 5 15 5 0 5
6 6 6 6 6 20 6 6 6 6 6
0 6 0 6 0 6 0 6 0 6 0
3 3 3 3 3 20 3 3 3 3 3
0 3 0 3 0 3 0 3 0 3 0
1 1 1 1 1 20 1 1 1 1 1
0 1 0 1 0 1 0 1 0 1 0
2 2 2 2 2 20 2 2 2 2 2
0 2 0 2 0 2 0 2 0 2 0
4 4 4 4 4 20 4 4 4 4 4
0 4 0 4 0 4 0 4 0 4 0
5 5 5 5 5 20 5 5 5 5 5
0 5 0 5 0 5 0 5 0 5 0
6 6 6 6 6 20 6 6 6 6 6
0 6 0 6 0 6 0 6 0 6 0
3 3 3 3 3 20 3 3 3 3 3
0 3 0 3 0 3 0 3 0 3 0
1 1 1 1 1 20 1 1 1 1 1
0 1 0 1 0 1 0 1 0 1 0
2 2 2 2 2 20 2 2 2 2 2
0 2 0 2 0 2 0 2 0 2 0
4 4 4 4 4 20 4 4 4 4 4
0 4 0 4 0 4 0 4 0 4 0
0 0 0 0 0 0 0 0 0 0 0
0 0 0 0 0 0 0 0 0 0 0
0 0 0 0 0 0 0 0 0 0 0
0 0 0 0 0 0 0 0 0 0 0
0 0 0 0 0 0 0 0 0 0 0
0 0 0 0 0 0 0 0 0 0 0
0 0 0 0 0 0 0 0 0 0 0
0 0 0 0 0 0 0 0 0 0 0
0 0 0 0 0 0 0 0 0 0 0
0 0 0 0 0 0 0 0 0 0 0
0 0 0 0 0 0 0 0 0 0 0
0 0 0 0 0 0 0 0 0 0 0
0 0 0 0 0 0 0 0 0 0 0
0 0 0 0 0 0 0 0 0 0 0
0 0 0 0 0 0 0 0 0 0 0
0 0 0 0 0 0 0 0 0 0 0
0 0 0 0 0 0 0 0 0 0 0
0 0 0 0 0 0 0 0 0 0 0
0 0 0 0 0 0 0 0 0 0 0
0 0 0 0 0 0 0 0 0 0 0
0 0 0 0 0 0 0 0 0 0 0
0 0 0 0 0 0 0 0 0 0 0
0 0 0 0 0 0 0 0 0 0 0
0 0 0 0 0 0 0 0 0 0 0
0 0 0 0 0 0 0 0 0 0 0
0 0 0 0 0 0 0 0 0 0 0
0 0 0 0 0 0 0 0 0 0 0
0 0 0 0 0 0 0 0 0 0 0
0 0 0 0 0 0 0 0 0 0 0
0 0 0 0 0 0 0 0 0 0 0
0 0 0 0 0 0 0 0 0 0 0
0 0 0 0 0 0 0 0 0 0 0
0 0 0 0 0 0 0 0 0 0 0
0 0 0 0 0 0 0 0 0 0 0
0 0 0 0 0 0 0 0 0 0 0
0 0 0 0 0 0 0 0 0 0 0
0 0 0 0 0 0 0 0 0 0 0
0 0 0 0 0 0 0 0 0 0 0
0 0 0 0 0 0 0 0 0 0 0
0 0 0 0 0 0 0 0 0 0 0
0 0 0 0 0 0 0 0 0 0 0
0 0 0 0 0 0 0 0 0 0 0
0 0 0 0 0 0 0 0 0 0 0
0 0 0 0 0 0 0 0 0 0 0
0 0 0 0 0 0 0 0 0 0 0