MODE 2
SIZE 11/70
LIMIT 0/30
COLOR LIMIT 4
STARS 2000/3000/4000
POWERUPS 0/0/1/0
7 7 5 15 7 7 7 7 7 7 7
0 5 5 5 7 7 7 4 4 0 0
0 0 5 5 6 6 6 4 14 4 0
0 0 0 6 5 5 0 4 4 0 0
0 0 0 6 5 5 5 0 0 0 0
0 4 4 7 5 5 6 6 6 0 0
0 4 14 4 6 7 6 5 5 0 0
0 4 4 6 7 6 5 5 5 0 0
6 6 6 6 4 4 0 5 5 6 6
7 7 7 4 4 4 7 7 6 5 5
6 6 6 6 4 4 7 7 6 5 5
0 4 4 6 20 20 2 2 2 5 5
0 4 4 4 0 0 0 1 1 2 6
0 4 4 6 6 0 1 1 1 2 6
0 0 0 6 2 2 2 1 1 6 6
0 20 20 6 1 1 2 6 0 0 0
0 6 6 20 1 1 1 2 6 4 4
6 2 2 2 1 1 6 6 4 4 4
0 6 1 1 2 6 7 7 7 4 4
0 1 1 1 2 6 4 4 6 20 20
2 2 1 1 6 6 4 4 4 6 0
1 2 6 7 7 7 4 4 6 6 6
1 1 2 6 4 4 20 5 5 0 0
1 6 6 4 4 4 5 5 5 0 0
0 6 6 7 4 4 7 5 5 6 6
6 4 4 7 5 5 7 1 1 6 6
6 4 4 4 5 5 5 1 1 1 6
0 4 4 0 5 5 0 1 1 0 0
0 0 0 0 0 0 0 0 0 0 0
0 0 0 0 0 0 0 0 0 0 0
0 0 0 0 0 0 0 0 0 0 0
0 0 0 0 0 0 0 0 0 0 0
0 0 0 0 0 0 0 0 0 0 0
0 0 0 0 0 0 0 0 0 0 0
0 0 0 0 0 0 0 0 0 0 0
0 0 0 0 0 0 0 0 0 0 0
0 0 0 0 0 0 0 0 0 0 0
0 0 0 0 0 0 0 0 0 0 0
0 0 0 0 0 0 0 0 0 0 0
0 0 0 0 0 0 0 0 0 0 0
0 0 0 0 0 0 0 0 0 0 0
0 0 0 0 0 0 0 0 0 0 0
0 0 0 0 0 0 0 0 0 0 0
0 0 0 0 0 0 0 0 0 0 0
0 0 0 0 0 0 0 0 0 0 0
0 0 0 0 0 0 0 0 0 0 0
0 0 0 0 0 0 0 0 0 0 0
0 0 0 0 0 0 0 0 0 0 0
0 0 0 0 0 0 0 0 0 0 0
0 0 0 0 0 0 0 0 0 0 0
0 0 0 0 0 0 0 0 0 0 0
0 0 0 0 0 0 0 0 0 0 0
0 0 0 0 0 0 0 0 0 0 0
0 0 0 0 0 0 0 0 0 0 0
0 0 0 0 0 0 0 0 0 0 0
0 0 0 0 0 0 0 0 0 0 0
0 0 0 0 0 0 0 0 0 0 0
0 0 0 0 0 0 0 0 0 0 0
0 0 0 0 0 0 0 0 0 0 0
0 0 0 0 0 0 0 0 0 0 0
0 0 0 0 0 0 0 0 0 0 0
0 0 0 0 0 0 0 0 0 0 0
0 0 0 0 0 0 0 0 0 0 0
0 0 0 0 0 0 0 0 0 0 0
0 0 0 0 0 0 0 0 0 0 0
0 0 0 0 0 0 0 0 0 0 0
0 0 0 0 0 0 0 0 0 0 0
0 0 0 0 0 0 0 0 0 0 0
0 0 0 0 0 0 0 0 0 0 0
0 0 0 0 0 0 0 0 0 0 0