MODE 2
SIZE 11/70
LIMIT 0/25
COLOR LIMIT 4
STARS 2200/3200/5200
POWERUPS 0/0/1/0
3 3 3 0 3 3 3 0 3 3 3
3 3 12 12 3 3 12 12 3 3 0
0 3 1 1 1 3 1 1 1 3 0
0 0 1 1 0 0 1 1 0 0 0
2 2 2 1 2 2 2 1 2 2 2
2 2 0 0 2 2 0 0 2 2 0
0 2 4 4 4 2 4 4 4 2 0
0 0 4 4 0 0 4 4 0 0 0
6 6 6 4 6 6 6 4 6 6 6
6 6 0 0 6 6 0 0 6 6 0
0 6 5 5 5 6 5 5 5 6 0
0 0 5 5 0 0 5 5 0 0 0
3 3 3 5 3 3 3 5 3 3 3
3 3 0 0 3 3 0 0 3 3 0
0 3 1 1 1 3 1 1 1 3 0
0 0 1 1 0 0 1 1 0 0 0
2 2 2 1 2 2 2 1 2 2 2
2 2 0 0 2 2 0 0 2 2 0
0 2 4 4 4 2 4 4 4 2 0
0 0 4 4 0 0 4 4 0 0 0
6 6 6 4 6 6 6 4 6 6 6
6 6 0 0 6 6 0 0 6 6 0
0 6 5 5 5 6 5 5 5 6 0
0 0 5 5 0 0 5 5 0 0 0
0 0 0 5 0 0 0 5 0 0 0
0 0 0 0 0 0 0 0 0 0 0
0 0 0 0 0 0 0 0 0 0 0
0 0 0 0 0 0 0 0 0 0 0
0 0 0 0 0 0 0 0 0 0 0
0 0 0 0 0 0 0 0 0 0 0
0 0 0 0 0 0 0 0 0 0 0
0 0 0 0 0 0 0 0 0 0 0
0 0 0 0 0 0 0 0 0 0 0
0 0 0 0 0 0 0 0 0 0 0
0 0 0 0 0 0 0 0 0 0 0
0 0 0 0 0 0 0 0 0 0 0
0 0 0 0 0 0 0 0 0 0 0
0 0 0 0 0 0 0 0 0 0 0
0 0 0 0 0 0 0 0 0 0 0
0 0 0 0 0 0 0 0 0 0 0
0 0 0 0 0 0 0 0 0 0 0
0 0 0 0 0 0 0 0 0 0 0
0 0 0 0 0 0 0 0 0 0 0
0 0 0 0 0 0 0 0 0 0 0
0 0 0 0 0 0 0 0 0 0 0
0 0 0 0 0 0 0 0 0 0 0
0 0 0 0 0 0 0 0 0 0 0
0 0 0 0 0 0 0 0 0 0 0
0 0 0 0 0 0 0 0 0 0 0
0 0 0 0 0 0 0 0 0 0 0
0 0 0 0 0 0 0 0 0 0 0
0 0 0 0 0 0 0 0 0 0 0
0 0 0 0 0 0 0 0 0 0 0
0 0 0 0 0 0 0 0 0 0 0
0 0 0 0 0 0 0 0 0 0 0
0 0 0 0 0 0 0 0 0 0 0
0 0 0 0 0 0 0 0 0 0 0
0 0 0 0 0 0 0 0 0 0 0
0 0 0 0 0 0 0 0 0 0 0
0 0 0 0 0 0 0 0 0 0 0
0 0 0 0 0 0 0 0 0 0 0
0 0 0 0 0 0 0 0 0 0 0
0 0 0 0 0 0 0 0 0 0 0
0 0 0 0 0 0 0 0 0 0 0
0 0 0 0 0 0 0 0 0 0 0
0 0 0 0 0 0 0 0 0 0 0
0 0 0 0 0 0 0 0 0 0 0
0 0 0 0 0 0 0 0 0 0 0
0 0 0 0 0 0 0 0 0 0 0
0 0 0 0 0 0 0 0 0 0 0