MODE 2
SIZE 11/70
LIMIT 0/30
COLOR LIMIT 4
STARS 2000/3000/4000
POWERUPS 0/0/0/0
1 1 1 1 12 1 1 12 1 1 1
18 3 3 3 3 3 3 3 3 3 18
18 18 3 3 18 3 3 18 3 3 18
18 18 3 18 18 3 18 18 3 18 18
2 2 2 20 20 12 2 2 2 2 2
4 4 4 4 4 4 4 20 20 4 4
18 4 4 18 4 4 18 4 4 18 4
18 4 18 18 4 18 18 4 18 18 4
3 3 20 20 12 3 3 3 3 3 3
6 6 6 6 6 6 6 20 20 6 6
18 6 6 18 6 6 18 6 6 18 6
18 6 18 18 6 18 18 6 18 18 6
4 4 4 20 20 12 4 4 4 4 4
2 2 2 2 2 2 2 20 20 2 2
18 2 2 18 2 2 18 2 2 18 2
18 2 18 18 2 18 18 2 18 18 2
5 5 20 20 5 5 5 5 5 5 5
3 3 3 3 3 3 3 20 20 3 3
18 3 3 18 3 3 18 3 3 18 3
18 3 18 18 3 18 18 3 18 18 3
6 6 20 20 6 6 6 6 6 6 6
0 0 0 0 0 0 0 0 0 0 0
0 0 0 0 0 0 0 0 0 0 0
0 0 0 0 0 0 0 0 0 0 0
0 0 0 0 0 0 0 0 0 0 0
0 0 0 0 0 0 0 0 0 0 0
0 0 0 0 0 0 0 0 0 0 0
0 0 0 0 0 0 0 0 0 0 0
0 0 0 0 0 0 0 0 0 0 0
0 0 0 0 0 0 0 0 0 0 0
0 0 0 0 0 0 0 0 0 0 0
0 0 0 0 0 0 0 0 0 0 0
0 0 0 0 0 0 0 0 0 0 0
0 0 0 0 0 0 0 0 0 0 0
0 0 0 0 0 0 0 0 0 0 0
0 0 0 0 0 0 0 0 0 0 0
0 0 0 0 0 0 0 0 0 0 0
0 0 0 0 0 0 0 0 0 0 0
0 0 0 0 0 0 0 0 0 0 0
0 0 0 0 0 0 0 0 0 0 0
0 0 0 0 0 0 0 0 0 0 0
0 0 0 0 0 0 0 0 0 0 0
0 0 0 0 0 0 0 0 0 0 0
0 0 0 0 0 0 0 0 0 0 0
0 0 0 0 0 0 0 0 0 0 0
0 0 0 0 0 0 0 0 0 0 0
0 0 0 0 0 0 0 0 0 0 0
0 0 0 0 0 0 0 0 0 0 0
0 0 0 0 0 0 0 0 0 0 0
0 0 0 0 0 0 0 0 0 0 0
0 0 0 0 0 0 0 0 0 0 0
0 0 0 0 0 0 0 0 0 0 0
0 0 0 0 0 0 0 0 0 0 0
0 0 0 0 0 0 0 0 0 0 0
0 0 0 0 0 0 0 0 0 0 0
0 0 0 0 0 0 0 0 0 0 0
0 0 0 0 0 0 0 0 0 0 0
0 0 0 0 0 0 0 0 0 0 0
0 0 0 0 0 0 0 0 0 0 0
0 0 0 0 0 0 0 0 0 0 0
0 0 0 0 0 0 0 0 0 0 0
0 0 0 0 0 0 0 0 0 0 0
0 0 0 0 0 0 0 0 0 0 0
0 0 0 0 0 0 0 0 0 0 0
0 0 0 0 0 0 0 0 0 0 0
0 0 0 0 0 0 0 0 0 0 0
0 0 0 0 0 0 0 0 0 0 0
0 0 0 0 0 0 0 0 0 0 0
0 0 0 0 0 0 0 0 0 0 0
0 0 0 0 0 0 0 0 0 0 0