MODE 2
SIZE 11/70
LIMIT 0/30
COLOR LIMIT 4
STARS 2200/4200/6200
POWERUPS 1/0/0/0
20 20 20 15 20 20 20 15 20 20 20
6 6 4 4 6 6 4 4 6 6 7
6 6 6 4 6 6 6 4 6 6 6
6 6 5 5 6 6 5 5 6 6 7
7 1 1 5 1 1 1 5 1 1 7
1 11 1 2 1 1 2 1 11 1 7
7 1 1 2 2 1 2 2 1 1 7
20 20 20 20 20 20 20 10 20 20 20
4 4 4 2 2 3 2 2 4 4 4
4 4 5 2 3 3 2 5 4 4 7
7 4 5 5 3 3 3 5 5 4 7
1 1 6 6 4 4 6 6 1 1 7
1 1 1 6 4 14 4 6 1 1 1
1 1 3 3 4 4 3 3 1 1 7
7 5 3 3 3 5 3 3 3 5 7
5 5 3 3 5 5 3 3 5 5 7
20 20 10 20 20 20 20 20 20 20 20
4 4 4 5 5 2 5 5 4 4 4
7 4 4 1 5 2 2 5 1 4 4
7 4 1 1 2 2 2 1 1 4 7
7 7 1 1 1 0 0 1 1 1 7
0 0 0 0 0 0 0 0 0 0 0
0 0 0 0 0 0 0 0 0 0 0
0 0 0 0 0 0 0 0 0 0 0
0 0 0 0 0 0 0 0 0 0 0
0 0 0 0 0 0 0 0 0 0 0
0 0 0 0 0 0 0 0 0 0 0
0 0 0 0 0 0 0 0 0 0 0
0 0 0 0 0 0 0 0 0 0 0
0 0 0 0 0 0 0 0 0 0 0
0 0 0 0 0 0 0 0 0 0 0
0 0 0 0 0 0 0 0 0 0 0
0 0 0 0 0 0 0 0 0 0 0
0 0 0 0 0 0 0 0 0 0 0
0 0 0 0 0 0 0 0 0 0 0
0 0 0 0 0 0 0 0 0 0 0
0 0 0 0 0 0 0 0 0 0 0
0 0 0 0 0 0 0 0 0 0 0
0 0 0 0 0 0 0 0 0 0 0
0 0 0 0 0 0 0 0 0 0 0
0 0 0 0 0 0 0 0 0 0 0
0 0 0 0 0 0 0 0 0 0 0
0 0 0 0 0 0 0 0 0 0 0
0 0 0 0 0 0 0 0 0 0 0
0 0 0 0 0 0 0 0 0 0 0
0 0 0 0 0 0 0 0 0 0 0
0 0 0 0 0 0 0 0 0 0 0
0 0 0 0 0 0 0 0 0 0 0
0 0 0 0 0 0 0 0 0 0 0
0 0 0 0 0 0 0 0 0 0 0
0 0 0 0 0 0 0 0 0 0 0
0 0 0 0 0 0 0 0 0 0 0
0 0 0 0 0 0 0 0 0 0 0
0 0 0 0 0 0 0 0 0 0 0
0 0 0 0 0 0 0 0 0 0 0
0 0 0 0 0 0 0 0 0 0 0
0 0 0 0 0 0 0 0 0 0 0
0 0 0 0 0 0 0 0 0 0 0
0 0 0 0 0 0 0 0 0 0 0
0 0 0 0 0 0 0 0 0 0 0
0 0 0 0 0 0 0 0 0 0 0
0 0 0 0 0 0 0 0 0 0 0
0 0 0 0 0 0 0 0 0 0 0
0 0 0 0 0 0 0 0 0 0 0
0 0 0 0 0 0 0 0 0 0 0
0 0 0 0 0 0 0 0 0 0 0
0 0 0 0 0 0 0 0 0 0 0
0 0 0 0 0 0 0 0 0 0 0
0 0 0 0 0 0 0 0 0 0 0
0 0 0 0 0 0 0 0 0 0 0