MODE 2
SIZE 11/70
LIMIT 0/40
COLOR LIMIT 4
STARS 1200/2200/3200
POWERUPS 1/0/0/0
5 5 15 5 5 5 5 5 15 5 5
1 1 1 6 6 6 6 1 1 1 2
2 1 1 4 6 6 6 4 1 1 2
2 1 4 4 6 6 4 4 1 2 2
2 2 4 4 4 6 4 4 4 2 2
2 4 4 4 20 10 4 4 4 2 2
18 18 18 18 18 18 18 18 18 18 18
2 1 11 1 3 3 3 1 11 1 2
2 2 1 1 3 3 3 3 1 1 2
2 2 1 3 3 3 3 3 1 2 2
2 2 2 3 3 3 3 3 3 2 2
18 18 18 18 18 18 18 18 18 18 18
2 2 3 3 1 11 1 3 3 2 2
2 3 3 3 1 1 3 3 3 2 2
2 2 3 3 5 1 5 3 3 2 2
18 18 18 5 5 5 5 18 18 18 18
6 6 6 6 5 5 5 6 6 6 6
6 6 6 2 5 5 2 6 6 6 7
7 6 6 2 2 5 2 2 6 6 7
7 6 2 2 2 2 2 2 6 7 7
0 0 0 0 0 0 0 0 0 0 0
0 0 0 0 0 0 0 0 0 0 0
0 0 0 0 0 0 0 0 0 0 0
0 0 0 0 0 0 0 0 0 0 0
0 0 0 0 0 0 0 0 0 0 0
0 0 0 0 0 0 0 0 0 0 0
0 0 0 0 0 0 0 0 0 0 0
0 0 0 0 0 0 0 0 0 0 0
0 0 0 0 0 0 0 0 0 0 0
0 0 0 0 0 0 0 0 0 0 0
0 0 0 0 0 0 0 0 0 0 0
0 0 0 0 0 0 0 0 0 0 0
0 0 0 0 0 0 0 0 0 0 0
0 0 0 0 0 0 0 0 0 0 0
0 0 0 0 0 0 0 0 0 0 0
0 0 0 0 0 0 0 0 0 0 0
0 0 0 0 0 0 0 0 0 0 0
0 0 0 0 0 0 0 0 0 0 0
0 0 0 0 0 0 0 0 0 0 0
0 0 0 0 0 0 0 0 0 0 0
0 0 0 0 0 0 0 0 0 0 0
0 0 0 0 0 0 0 0 0 0 0
0 0 0 0 0 0 0 0 0 0 0
0 0 0 0 0 0 0 0 0 0 0
0 0 0 0 0 0 0 0 0 0 0
0 0 0 0 0 0 0 0 0 0 0
0 0 0 0 0 0 0 0 0 0 0
0 0 0 0 0 0 0 0 0 0 0
0 0 0 0 0 0 0 0 0 0 0
0 0 0 0 0 0 0 0 0 0 0
0 0 0 0 0 0 0 0 0 0 0
0 0 0 0 0 0 0 0 0 0 0
0 0 0 0 0 0 0 0 0 0 0
0 0 0 0 0 0 0 0 0 0 0
0 0 0 0 0 0 0 0 0 0 0
0 0 0 0 0 0 0 0 0 0 0
0 0 0 0 0 0 0 0 0 0 0
0 0 0 0 0 0 0 0 0 0 0
0 0 0 0 0 0 0 0 0 0 0
0 0 0 0 0 0 0 0 0 0 0
0 0 0 0 0 0 0 0 0 0 0
0 0 0 0 0 0 0 0 0 0 0
0 0 0 0 0 0 0 0 0 0 0
0 0 0 0 0 0 0 0 0 0 0
0 0 0 0 0 0 0 0 0 0 0
0 0 0 0 0 0 0 0 0 0 0
0 0 0 0 0 0 0 0 0 0 0
0 0 0 0 0 0 0 0 0 0 0
0 0 0 0 0 0 0 0 0 0 0
0 0 0 0 0 0 0 0 0 0 0