MODE 2
SIZE 11/70
LIMIT 0/35
COLOR LIMIT 4
STARS 3200/4200/6200
POWERUPS 1/0/0/0
17 17 17 16 17 17 10 17 17 17 17
4 4 4 4 4 4 4 4 4 4 4
1 4 1 4 1 4 1 4 1 4 1
1 1 1 1 1 1 1 1 1 1 1
2 1 2 1 2 1 2 1 2 1 2
2 2 2 2 2 2 2 2 2 2 2
3 2 3 2 3 2 3 2 3 2 3
3 3 3 3 3 3 3 3 3 3 3
6 3 6 3 6 3 16 3 6 3 6
6 6 6 6 6 6 6 6 6 6 6
5 6 5 6 15 6 5 6 5 6 5
5 5 5 5 5 5 5 5 5 5 5
4 5 4 5 4 5 4 5 4 5 4
4 4 4 4 4 4 4 4 4 4 4
1 4 1 4 1 4 1 4 1 4 1
1 1 1 1 1 1 1 1 1 1 1
2 1 2 1 2 1 2 1 2 1 2
2 2 2 2 2 2 2 2 2 2 2
3 2 3 2 3 2 3 2 3 2 3
3 3 3 3 3 3 3 3 3 3 3
6 3 6 3 16 3 6 3 6 3 6
6 6 6 6 6 6 6 6 6 6 6
5 6 5 6 5 6 5 6 5 6 5
5 5 5 5 5 5 5 5 5 5 5
0 5 0 5 0 5 0 5 0 5 0
0 0 0 0 0 0 0 0 0 0 0
0 0 0 0 0 0 0 0 0 0 0
0 0 0 0 0 0 0 0 0 0 0
0 0 0 0 0 0 0 0 0 0 0
0 0 0 0 0 0 0 0 0 0 0
0 0 0 0 0 0 0 0 0 0 0
0 0 0 0 0 0 0 0 0 0 0
0 0 0 0 0 0 0 0 0 0 0
0 0 0 0 0 0 0 0 0 0 0
0 0 0 0 0 0 0 0 0 0 0
0 0 0 0 0 0 0 0 0 0 0
0 0 0 0 0 0 0 0 0 0 0
0 0 0 0 0 0 0 0 0 0 0
0 0 0 0 0 0 0 0 0 0 0
0 0 0 0 0 0 0 0 0 0 0
0 0 0 0 0 0 0 0 0 0 0
0 0 0 0 0 0 0 0 0 0 0
0 0 0 0 0 0 0 0 0 0 0
0 0 0 0 0 0 0 0 0 0 0
0 0 0 0 0 0 0 0 0 0 0
0 0 0 0 0 0 0 0 0 0 0
0 0 0 0 0 0 0 0 0 0 0
0 0 0 0 0 0 0 0 0 0 0
0 0 0 0 0 0 0 0 0 0 0
0 0 0 0 0 0 0 0 0 0 0
0 0 0 0 0 0 0 0 0 0 0
0 0 0 0 0 0 0 0 0 0 0
0 0 0 0 0 0 0 0 0 0 0
0 0 0 0 0 0 0 0 0 0 0
0 0 0 0 0 0 0 0 0 0 0
0 0 0 0 0 0 0 0 0 0 0
0 0 0 0 0 0 0 0 0 0 0
0 0 0 0 0 0 0 0 0 0 0
0 0 0 0 0 0 0 0 0 0 0
0 0 0 0 0 0 0 0 0 0 0
0 0 0 0 0 0 0 0 0 0 0
0 0 0 0 0 0 0 0 0 0 0
0 0 0 0 0 0 0 0 0 0 0
0 0 0 0 0 0 0 0 0 0 0
0 0 0 0 0 0 0 0 0 0 0
0 0 0 0 0 0 0 0 0 0 0
0 0 0 0 0 0 0 0 0 0 0
0 0 0 0 0 0 0 0 0 0 0
0 0 0 0 0 0 0 0 0 0 0
0 0 0 0 0 0 0 0 0 0 0