MODE 2
SIZE 11/70
LIMIT 0/40
COLOR LIMIT 4
STARS 2200/4200/6200
POWERUPS 1/0/1/0
20 20 20 20 20 20 20 20 20 20 20
1 20 1 1 10 1 1 20 1 1 20
2 2 2 11 2 2 11 2 2 11 2
4 8 4 4 6 4 4 8 4 4 6
4 5 5 4 5 5 4 5 5 4 5
3 5 3 3 5 3 3 5 3 3 5
3 6 6 3 6 6 3 6 6 3 6
5 16 5 5 16 5 5 16 5 5 16
2 2 4 2 2 4 2 2 4 2 2
1 4 4 1 4 4 1 4 4 1 4
1 1 6 1 1 6 1 1 6 1 1
5 6 6 5 6 6 5 6 6 5 3
5 5 9 5 5 3 5 5 3 5 5
2 9 9 2 3 3 2 3 3 2 3
2 2 5 2 2 5 1 2 5 2 2
1 5 5 1 5 5 1 5 5 1 5
1 1 2 1 1 2 1 1 2 1 1
3 2 2 9 2 2 3 2 2 3 5
3 3 6 9 9 6 3 3 6 3 3
5 6 6 5 6 6 5 6 6 5 2
5 5 3 5 5 3 5 5 9 5 5
1 3 3 1 3 3 1 9 9 1 2
1 1 2 1 1 2 1 1 2 1 1
4 2 2 4 2 2 4 2 2 4 5
4 4 5 4 4 5 4 4 5 4 4
0 0 0 0 0 0 0 0 0 0 0
0 0 0 0 0 0 0 0 0 0 0
0 0 0 0 0 0 0 0 0 0 0
0 0 0 0 0 0 0 0 0 0 0
0 0 0 0 0 0 0 0 0 0 0
0 0 0 0 0 0 0 0 0 0 0
0 0 0 0 0 0 0 0 0 0 0
0 0 0 0 0 0 0 0 0 0 0
0 0 0 0 0 0 0 0 0 0 0
0 0 0 0 0 0 0 0 0 0 0
0 0 0 0 0 0 0 0 0 0 0
0 0 0 0 0 0 0 0 0 0 0
0 0 0 0 0 0 0 0 0 0 0
0 0 0 0 0 0 0 0 0 0 0
0 0 0 0 0 0 0 0 0 0 0
0 0 0 0 0 0 0 0 0 0 0
0 0 0 0 0 0 0 0 0 0 0
0 0 0 0 0 0 0 0 0 0 0
0 0 0 0 0 0 0 0 0 0 0
0 0 0 0 0 0 0 0 0 0 0
0 0 0 0 0 0 0 0 0 0 0
0 0 0 0 0 0 0 0 0 0 0
0 0 0 0 0 0 0 0 0 0 0
0 0 0 0 0 0 0 0 0 0 0
0 0 0 0 0 0 0 0 0 0 0
0 0 0 0 0 0 0 0 0 0 0
0 0 0 0 0 0 0 0 0 0 0
0 0 0 0 0 0 0 0 0 0 0
0 0 0 0 0 0 0 0 0 0 0
0 0 0 0 0 0 0 0 0 0 0
0 0 0 0 0 0 0 0 0 0 0
0 0 0 0 0 0 0 0 0 0 0
0 0 0 0 0 0 0 0 0 0 0
0 0 0 0 0 0 0 0 0 0 0
0 0 0 0 0 0 0 0 0 0 0
0 0 0 0 0 0 0 0 0 0 0
0 0 0 0 0 0 0 0 0 0 0
0 0 0 0 0 0 0 0 0 0 0
0 0 0 0 0 0 0 0 0 0 0
0 0 0 0 0 0 0 0 0 0 0
0 0 0 0 0 0 0 0 0 0 0
0 0 0 0 0 0 0 0 0 0 0
0 0 0 0 0 0 0 0 0 0 0
0 0 0 0 0 0 0 0 0 0 0
0 0 0 0 0 0 0 0 0 0 0