MODE 2
SIZE 11/70
LIMIT 0/35
COLOR LIMIT 4
STARS 2000/4000/6000
POWERUPS 0/0/0/0
20 20 5 6 4 2 3 1 15 20 20
20 20 5 6 4 2 3 1 15 20 20
20 20 5 6 4 2 3 1 15 20 20
20 20 1 3 2 4 6 5 11 20 20
20 20 1 3 2 4 6 5 11 20 20
20 20 1 3 2 4 6 5 11 20 20
20 20 5 6 4 2 3 1 5 20 20
20 20 5 6 4 2 3 1 5 20 20
20 20 5 6 4 2 3 1 5 20 20
20 20 1 3 2 4 6 5 1 20 20
20 20 1 3 2 4 6 5 1 20 20
20 20 1 3 2 4 6 5 1 20 20
20 20 5 6 4 2 3 1 5 20 20
20 20 5 6 4 2 3 1 5 20 20
20 20 5 6 4 2 3 1 5 20 20
20 20 1 3 2 4 6 5 1 20 20
20 20 1 3 2 4 6 5 1 20 20
20 20 1 3 2 4 6 5 1 20 20
20 20 5 6 4 2 3 1 5 20 20
20 20 5 6 4 2 3 1 5 20 20
20 20 5 6 4 2 3 1 5 20 20
0 0 0 0 0 0 0 0 0 0 0
0 0 0 0 0 0 0 0 0 0 0
0 0 0 0 0 0 0 0 0 0 0
0 0 0 0 0 0 0 0 0 0 0
0 0 0 0 0 0 0 0 0 0 0
0 0 0 0 0 0 0 0 0 0 0
0 0 0 0 0 0 0 0 0 0 0
0 0 0 0 0 0 0 0 0 0 0
0 0 0 0 0 0 0 0 0 0 0
0 0 0 0 0 0 0 0 0 0 0
0 0 0 0 0 0 0 0 0 0 0
0 0 0 0 0 0 0 0 0 0 0
0 0 0 0 0 0 0 0 0 0 0
0 0 0 0 0 0 0 0 0 0 0
0 0 0 0 0 0 0 0 0 0 0
0 0 0 0 0 0 0 0 0 0 0
0 0 0 0 0 0 0 0 0 0 0
0 0 0 0 0 0 0 0 0 0 0
0 0 0 0 0 0 0 0 0 0 0
0 0 0 0 0 0 0 0 0 0 0
0 0 0 0 0 0 0 0 0 0 0
0 0 0 0 0 0 0 0 0 0 0
0 0 0 0 0 0 0 0 0 0 0
0 0 0 0 0 0 0 0 0 0 0
0 0 0 0 0 0 0 0 0 0 0
0 0 0 0 0 0 0 0 0 0 0
0 0 0 0 0 0 0 0 0 0 0
0 0 0 0 0 0 0 0 0 0 0
0 0 0 0 0 0 0 0 0 0 0
0 0 0 0 0 0 0 0 0 0 0
0 0 0 0 0 0 0 0 0 0 0
0 0 0 0 0 0 0 0 0 0 0
0 0 0 0 0 0 0 0 0 0 0
0 0 0 0 0 0 0 0 0 0 0
0 0 0 0 0 0 0 0 0 0 0
0 0 0 0 0 0 0 0 0 0 0
0 0 0 0 0 0 0 0 0 0 0
0 0 0 0 0 0 0 0 0 0 0
0 0 0 0 0 0 0 0 0 0 0
0 0 0 0 0 0 0 0 0 0 0
0 0 0 0 0 0 0 0 0 0 0
0 0 0 0 0 0 0 0 0 0 0
0 0 0 0 0 0 0 0 0 0 0
0 0 0 0 0 0 0 0 0 0 0
0 0 0 0 0 0 0 0 0 0 0
0 0 0 0 0 0 0 0 0 0 0
0 0 0 0 0 0 0 0 0 0 0
0 0 0 0 0 0 0 0 0 0 0
0 0 0 0 0 0 0 0 0 0 0