MODE 2
SIZE 11/70
LIMIT 0/35
COLOR LIMIT 4
STARS 3200/5200/6200
POWERUPS 1/0/0/0
20 3 3 20 20 1 1 20 20 3 3
3 8 3 15 1 1 1 15 3 8 3
20 3 3 20 20 1 1 20 20 3 3
18 18 2 2 2 5 2 2 2 18 18
18 18 18 2 2 5 5 2 2 18 18
18 18 6 6 5 20 5 6 6 18 18
4 4 6 6 6 5 5 6 6 6 4
4 4 6 6 4 5 4 6 6 4 4
4 4 1 1 4 4 4 4 1 1 4
2 1 1 1 4 4 4 1 1 1 2
2 2 1 1 3 4 4 3 1 1 2
2 5 5 3 3 4 3 3 5 5 2
0 5 5 5 3 7 7 3 5 5 5
0 5 5 18 7 7 7 18 5 5 0
20 20 20 18 18 7 7 18 18 20 20
0 6 6 18 18 18 18 18 6 6 0
0 6 6 6 7 7 7 7 6 6 6
0 6 6 4 7 7 7 4 6 6 0
0 0 0 4 4 7 7 4 4 0 0
0 0 0 4 0 7 0 4 0 0 0
0 0 0 0 0 0 0 0 0 0 0
0 0 0 0 0 0 0 0 0 0 0
0 0 0 0 0 0 0 0 0 0 0
0 0 0 0 0 0 0 0 0 0 0
0 0 0 0 0 0 0 0 0 0 0
0 0 0 0 0 0 0 0 0 0 0
0 0 0 0 0 0 0 0 0 0 0
0 0 0 0 0 0 0 0 0 0 0
0 0 0 0 0 0 0 0 0 0 0
0 0 0 0 0 0 0 0 0 0 0
0 0 0 0 0 0 0 0 0 0 0
0 0 0 0 0 0 0 0 0 0 0
0 0 0 0 0 0 0 0 0 0 0
0 0 0 0 0 0 0 0 0 0 0
0 0 0 0 0 0 0 0 0 0 0
0 0 0 0 0 0 0 0 0 0 0
0 0 0 0 0 0 0 0 0 0 0
0 0 0 0 0 0 0 0 0 0 0
0 0 0 0 0 0 0 0 0 0 0
0 0 0 0 0 0 0 0 0 0 0
0 0 0 0 0 0 0 0 0 0 0
0 0 0 0 0 0 0 0 0 0 0
0 0 0 0 0 0 0 0 0 0 0
0 0 0 0 0 0 0 0 0 0 0
0 0 0 0 0 0 0 0 0 0 0
0 0 0 0 0 0 0 0 0 0 0
0 0 0 0 0 0 0 0 0 0 0
0 0 0 0 0 0 0 0 0 0 0
0 0 0 0 0 0 0 0 0 0 0
0 0 0 0 0 0 0 0 0 0 0
0 0 0 0 0 0 0 0 0 0 0
0 0 0 0 0 0 0 0 0 0 0
0 0 0 0 0 0 0 0 0 0 0
0 0 0 0 0 0 0 0 0 0 0
0 0 0 0 0 0 0 0 0 0 0
0 0 0 0 0 0 0 0 0 0 0
0 0 0 0 0 0 0 0 0 0 0
0 0 0 0 0 0 0 0 0 0 0
0 0 0 0 0 0 0 0 0 0 0
0 0 0 0 0 0 0 0 0 0 0
0 0 0 0 0 0 0 0 0 0 0
0 0 0 0 0 0 0 0 0 0 0
0 0 0 0 0 0 0 0 0 0 0
0 0 0 0 0 0 0 0 0 0 0
0 0 0 0 0 0 0 0 0 0 0
0 0 0 0 0 0 0 0 0 0 0
0 0 0 0 0 0 0 0 0 0 0
0 0 0 0 0 0 0 0 0 0 0
0 0 0 0 0 0 0 0 0 0 0
0 0 0 0 0 0 0 0 0 0 0