MODE 2
SIZE 11/70
LIMIT 0/40
COLOR LIMIT 4
STARS 3200/5200/6200
POWERUPS 1/0/1/0
17 17 14 14 17 17 17 14 14 17 17
6 6 20 4 2 2 4 20 6 6 6
4 6 5 5 1 2 1 5 5 6 4
5 5 2 5 1 1 5 4 2 5 5
6 6 5 20 20 3 3 20 20 5 6
4 4 6 2 4 3 4 2 6 4 4
4 4 4 6 1 4 4 1 6 4 4
5 5 2 4 1 4 1 4 2 5 5
4 4 20 20 4 3 3 20 20 5 4
4 4 6 2 4 3 4 2 6 4 4
4 4 4 6 1 6 6 1 6 4 4
5 5 2 4 1 6 1 4 2 5 5
4 4 5 2 4 20 20 4 2 5 4
6 6 6 2 4 3 4 2 6 6 6
4 4 5 5 6 1 6 5 5 4 4
4 20 20 5 3 3 5 20 20 4 4
6 6 6 2 4 3 4 2 6 6 6
4 4 4 2 5 5 2 4 4 4 4
4 4 4 20 20 2 20 20 4 4 4
6 6 6 4 2 2 4 6 6 6 6
3 3 3 1 1 2 1 1 3 3 3
0 0 0 3 1 1 3 0 0 0 0
0 0 0 0 3 20 3 0 0 0 0
0 0 0 0 0 0 0 0 0 0 0
0 0 0 0 0 0 0 0 0 0 0
0 0 0 0 0 0 0 0 0 0 0
0 0 0 0 0 0 0 0 0 0 0
0 0 0 0 0 0 0 0 0 0 0
0 0 0 0 0 0 0 0 0 0 0
0 0 0 0 0 0 0 0 0 0 0
0 0 0 0 0 0 0 0 0 0 0
0 0 0 0 0 0 0 0 0 0 0
0 0 0 0 0 0 0 0 0 0 0
0 0 0 0 0 0 0 0 0 0 0
0 0 0 0 0 0 0 0 0 0 0
0 0 0 0 0 0 0 0 0 0 0
0 0 0 0 0 0 0 0 0 0 0
0 0 0 0 0 0 0 0 0 0 0
0 0 0 0 0 0 0 0 0 0 0
0 0 0 0 0 0 0 0 0 0 0
0 0 0 0 0 0 0 0 0 0 0
0 0 0 0 0 0 0 0 0 0 0
0 0 0 0 0 0 0 0 0 0 0
0 0 0 0 0 0 0 0 0 0 0
0 0 0 0 0 0 0 0 0 0 0
0 0 0 0 0 0 0 0 0 0 0
0 0 0 0 0 0 0 0 0 0 0
0 0 0 0 0 0 0 0 0 0 0
0 0 0 0 0 0 0 0 0 0 0
0 0 0 0 0 0 0 0 0 0 0
0 0 0 0 0 0 0 0 0 0 0
0 0 0 0 0 0 0 0 0 0 0
0 0 0 0 0 0 0 0 0 0 0
0 0 0 0 0 0 0 0 0 0 0
0 0 0 0 0 0 0 0 0 0 0
0 0 0 0 0 0 0 0 0 0 0
0 0 0 0 0 0 0 0 0 0 0
0 0 0 0 0 0 0 0 0 0 0
0 0 0 0 0 0 0 0 0 0 0
0 0 0 0 0 0 0 0 0 0 0
0 0 0 0 0 0 0 0 0 0 0
0 0 0 0 0 0 0 0 0 0 0
0 0 0 0 0 0 0 0 0 0 0
0 0 0 0 0 0 0 0 0 0 0
0 0 0 0 0 0 0 0 0 0 0
0 0 0 0 0 0 0 0 0 0 0
0 0 0 0 0 0 0 0 0 0 0
0 0 0 0 0 0 0 0 0 0 0
0 0 0 0 0 0 0 0 0 0 0
0 0 0 0 0 0 0 0 0 0 0