MODE 2
SIZE 11/70
LIMIT 0/45
COLOR LIMIT 4
STARS 3200/5200/6200
POWERUPS 1/0/1/0
7 7 20 20 18 18 18 20 20 7 7
7 20 11 20 18 18 20 11 20 7 7
7 7 20 20 18 18 18 20 20 7 7
6 6 10 3 20 20 3 3 6 6 6
6 6 6 3 20 15 20 3 6 6 6
18 18 18 18 20 20 10 18 18 18 18
1 1 20 20 1 4 1 20 20 1 1
4 20 12 20 4 4 20 12 20 4 4
1 1 20 20 1 4 1 20 20 1 1
18 18 18 18 20 20 18 18 18 18 18
5 5 2 5 20 14 20 5 2 5 5
5 2 2 5 20 20 5 2 2 5 5
18 18 18 18 18 18 18 18 18 18 18
6 6 20 20 6 6 20 20 6 6 3
3 6 20 2 20 6 20 2 20 6 3
3 3 20 20 3 3 20 20 3 3 3
7 7 7 7 7 7 7 7 7 7 7
2 7 7 1 1 1 1 7 7 2 4
4 2 7 1 1 1 1 1 7 2 4
4 2 2 1 1 1 1 2 2 4 4
0 0 0 0 0 0 0 0 0 0 0
0 0 0 0 0 0 0 0 0 0 0
0 0 0 0 0 0 0 0 0 0 0
0 0 0 0 0 0 0 0 0 0 0
0 0 0 0 0 0 0 0 0 0 0
0 0 0 0 0 0 0 0 0 0 0
0 0 0 0 0 0 0 0 0 0 0
0 0 0 0 0 0 0 0 0 0 0
0 0 0 0 0 0 0 0 0 0 0
0 0 0 0 0 0 0 0 0 0 0
0 0 0 0 0 0 0 0 0 0 0
0 0 0 0 0 0 0 0 0 0 0
0 0 0 0 0 0 0 0 0 0 0
0 0 0 0 0 0 0 0 0 0 0
0 0 0 0 0 0 0 0 0 0 0
0 0 0 0 0 0 0 0 0 0 0
0 0 0 0 0 0 0 0 0 0 0
0 0 0 0 0 0 0 0 0 0 0
0 0 0 0 0 0 0 0 0 0 0
0 0 0 0 0 0 0 0 0 0 0
0 0 0 0 0 0 0 0 0 0 0
0 0 0 0 0 0 0 0 0 0 0
0 0 0 0 0 0 0 0 0 0 0
0 0 0 0 0 0 0 0 0 0 0
0 0 0 0 0 0 0 0 0 0 0
0 0 0 0 0 0 0 0 0 0 0
0 0 0 0 0 0 0 0 0 0 0
0 0 0 0 0 0 0 0 0 0 0
0 0 0 0 0 0 0 0 0 0 0
0 0 0 0 0 0 0 0 0 0 0
0 0 0 0 0 0 0 0 0 0 0
0 0 0 0 0 0 0 0 0 0 0
0 0 0 0 0 0 0 0 0 0 0
0 0 0 0 0 0 0 0 0 0 0
0 0 0 0 0 0 0 0 0 0 0
0 0 0 0 0 0 0 0 0 0 0
0 0 0 0 0 0 0 0 0 0 0
0 0 0 0 0 0 0 0 0 0 0
0 0 0 0 0 0 0 0 0 0 0
0 0 0 0 0 0 0 0 0 0 0
0 0 0 0 0 0 0 0 0 0 0
0 0 0 0 0 0 0 0 0 0 0
0 0 0 0 0 0 0 0 0 0 0
0 0 0 0 0 0 0 0 0 0 0
0 0 0 0 0 0 0 0 0 0 0
0 0 0 0 0 0 0 0 0 0 0
0 0 0 0 0 0 0 0 0 0 0
0 0 0 0 0 0 0 0 0 0 0
0 0 0 0 0 0 0 0 0 0 0
0 0 0 0 0 0 0 0 0 0 0