MODE 2
SIZE 11/70
LIMIT 0/15
COLOR LIMIT 4
STARS 2200/4200/6200
POWERUPS 0/0/0/0
7 1 1 7 7 7 7 4 4 7 7
1 15 1 7 2 2 4 7 4 7 7
7 1 1 7 2 7 2 4 4 1 1
7 2 2 7 2 2 7 7 1 15 1
7 2 7 2 4 4 7 2 2 1 1
7 2 2 4 7 4 2 7 2 7 7
7 1 1 7 4 4 7 2 2 7 7
1 15 1 7 2 2 7 7 7 7 7
7 1 1 7 2 7 2 7 7 1 1
7 2 2 7 2 2 7 7 1 15 1
7 2 7 2 7 7 7 2 2 1 1
7 2 2 7 7 7 2 7 2 7 7
7 1 1 7 2 2 7 2 2 7 7
1 15 1 2 7 2 7 7 2 2 7
7 1 1 7 2 2 7 7 2 7 2
7 2 2 7 7 7 7 7 2 2 7
7 2 7 2 7 2 2 7 7 1 1
7 2 2 7 2 7 2 7 1 15 1
7 7 7 4 4 2 2 7 7 1 1
0 0 4 7 4 0 0 0 0 0 0
0 0 0 4 4 0 0 0 0 0 0
0 0 0 0 0 0 0 0 0 0 0
0 0 0 0 0 0 0 0 0 0 0
0 0 0 0 0 0 0 0 0 0 0
0 0 0 0 0 0 0 0 0 0 0
0 0 0 0 0 0 0 0 0 0 0
0 0 0 0 0 0 0 0 0 0 0
0 0 0 0 0 0 0 0 0 0 0
0 0 0 0 0 0 0 0 0 0 0
0 0 0 0 0 0 0 0 0 0 0
0 0 0 0 0 0 0 0 0 0 0
0 0 0 0 0 0 0 0 0 0 0
0 0 0 0 0 0 0 0 0 0 0
0 0 0 0 0 0 0 0 0 0 0
0 0 0 0 0 0 0 0 0 0 0
0 0 0 0 0 0 0 0 0 0 0
0 0 0 0 0 0 0 0 0 0 0
0 0 0 0 0 0 0 0 0 0 0
0 0 0 0 0 0 0 0 0 0 0
0 0 0 0 0 0 0 0 0 0 0
0 0 0 0 0 0 0 0 0 0 0
0 0 0 0 0 0 0 0 0 0 0
0 0 0 0 0 0 0 0 0 0 0
0 0 0 0 0 0 0 0 0 0 0
0 0 0 0 0 0 0 0 0 0 0
0 0 0 0 0 0 0 0 0 0 0
0 0 0 0 0 0 0 0 0 0 0
0 0 0 0 0 0 0 0 0 0 0
0 0 0 0 0 0 0 0 0 0 0
0 0 0 0 0 0 0 0 0 0 0
0 0 0 0 0 0 0 0 0 0 0
0 0 0 0 0 0 0 0 0 0 0
0 0 0 0 0 0 0 0 0 0 0
0 0 0 0 0 0 0 0 0 0 0
0 0 0 0 0 0 0 0 0 0 0
0 0 0 0 0 0 0 0 0 0 0
0 0 0 0 0 0 0 0 0 0 0
0 0 0 0 0 0 0 0 0 0 0
0 0 0 0 0 0 0 0 0 0 0
0 0 0 0 0 0 0 0 0 0 0
0 0 0 0 0 0 0 0 0 0 0
0 0 0 0 0 0 0 0 0 0 0
0 0 0 0 0 0 0 0 0 0 0
0 0 0 0 0 0 0 0 0 0 0
0 0 0 0 0 0 0 0 0 0 0
0 0 0 0 0 0 0 0 0 0 0
0 0 0 0 0 0 0 0 0 0 0
0 0 0 0 0 0 0 0 0 0 0
0 0 0 0 0 0 0 0 0 0 0
0 0 0 0 0 0 0 0 0 0 0