MODE 2
SIZE 11/70
LIMIT 0/40
COLOR LIMIT 4
STARS 2200/4200/6200
POWERUPS 0/0/0/0
7 4 4 7 11 11 7 7 4 4 7
4 4 4 1 1 1 0 4 4 4 0
0 4 4 0 1 1 0 0 4 4 0
0 6 6 0 4 4 0 6 6 0 0
0 6 6 6 4 4 4 6 6 6 0
0 6 6 0 4 4 0 6 6 0 0
7 7 7 11 11 6 6 11 11 7 7
0 4 4 0 6 6 6 0 4 4 0
0 4 4 4 0 6 6 0 4 4 4
0 4 4 0 0 0 0 0 4 4 0
0 0 6 6 0 4 4 0 6 6 0
0 6 6 6 4 4 4 6 6 6 0
0 0 6 6 0 4 4 0 6 6 0
7 7 7 7 6 6 7 7 7 7 7
0 4 4 0 6 6 6 0 4 4 0
4 4 4 0 6 6 0 4 4 4 0
0 4 4 7 7 7 7 7 4 4 0
0 6 6 0 4 4 0 6 6 0 0
0 6 6 6 4 4 4 6 6 6 0
0 6 6 0 4 4 0 6 6 0 0
19 19 19 19 19 10 19 19 19 19 19
0 4 4 0 6 6 0 4 4 0 0
0 4 4 4 6 6 6 4 4 4 0
0 4 4 0 6 6 0 4 4 0 0
20 20 20 20 20 20 20 20 20 20 20
7 6 6 7 4 4 7 6 6 7 3
0 6 6 6 4 4 4 6 6 6 3
0 6 6 0 4 4 0 6 6 0 3
3 3 7 1 1 7 2 2 7 3 3
3 3 1 1 1 2 2 2 3 3 3
3 3 0 1 1 7 2 2 7 3 3
0 0 2 2 7 7 1 1 7 7 7
0 0 2 2 2 7 1 1 1 3 3
0 0 2 2 0 0 1 1 3 3 3
0 0 0 0 0 0 0 0 0 3 3
0 0 0 0 0 0 0 0 0 0 0
0 0 0 0 0 0 0 0 0 0 0
0 0 0 0 0 0 0 0 0 0 0
0 0 0 0 0 0 0 0 0 0 0
0 0 0 0 0 0 0 0 0 0 0
0 0 0 0 0 0 0 0 0 0 0
0 0 0 0 0 0 0 0 0 0 0
0 0 0 0 0 0 0 0 0 0 0
0 0 0 0 0 0 0 0 0 0 0
0 0 0 0 0 0 0 0 0 0 0
0 0 0 0 0 0 0 0 0 0 0
0 0 0 0 0 0 0 0 0 0 0
0 0 0 0 0 0 0 0 0 0 0
0 0 0 0 0 0 0 0 0 0 0
0 0 0 0 0 0 0 0 0 0 0
0 0 0 0 0 0 0 0 0 0 0
0 0 0 0 0 0 0 0 0 0 0
0 0 0 0 0 0 0 0 0 0 0
0 0 0 0 0 0 0 0 0 0 0
0 0 0 0 0 0 0 0 0 0 0
0 0 0 0 0 0 0 0 0 0 0
0 0 0 0 0 0 0 0 0 0 0
0 0 0 0 0 0 0 0 0 0 0
0 0 0 0 0 0 0 0 0 0 0
0 0 0 0 0 0 0 0 0 0 0
0 0 0 0 0 0 0 0 0 0 0
0 0 0 0 0 0 0 0 0 0 0
0 0 0 0 0 0 0 0 0 0 0
0 0 0 0 0 0 0 0 0 0 0
0 0 0 0 0 0 0 0 0 0 0
0 0 0 0 0 0 0 0 0 0 0
0 0 0 0 0 0 0 0 0 0 0
0 0 0 0 0 0 0 0 0 0 0
0 0 0 0 0 0 0 0 0 0 0
0 0 0 0 0 0 0 0 0 0 0