MODE 2
SIZE 11/70
LIMIT 0/40
COLOR LIMIT 4
STARS 2200/4200/6200
POWERUPS 0/0/0/0
1 1 2 15 15 2 15 15 2 1 1
1 2 2 1 2 2 1 2 2 1 2
4 4 6 4 4 6 4 4 6 4 4
4 6 6 4 6 6 4 6 6 4 6
1 1 2 1 1 2 1 1 2 1 1
1 2 10 1 2 2 1 2 2 1 2
4 4 6 4 4 6 4 4 6 4 4
4 6 6 4 6 6 4 6 10 4 6
1 1 2 1 1 10 1 1 2 1 1
1 2 2 1 2 2 1 2 2 1 2
4 4 6 4 4 6 4 4 6 4 4
4 6 10 4 6 6 4 6 6 4 6
1 1 2 1 1 2 1 1 2 1 1
1 2 2 1 2 2 1 2 2 1 2
4 4 6 4 4 10 4 4 6 4 4
4 6 6 4 6 6 4 6 6 4 6
1 1 2 1 1 2 1 1 2 1 1
1 2 2 1 2 2 10 2 2 1 2
4 4 6 4 4 6 4 4 6 4 4
4 6 6 4 6 6 4 6 6 4 6
0 0 0 0 0 0 0 0 0 0 0
0 0 0 0 0 0 0 0 0 0 0
0 0 0 0 0 0 0 0 0 0 0
0 0 0 0 0 0 0 0 0 0 0
0 0 0 0 0 0 0 0 0 0 0
0 0 0 0 0 0 0 0 0 0 0
0 0 0 0 0 0 0 0 0 0 0
0 0 0 0 0 0 0 0 0 0 0
0 0 0 0 0 0 0 0 0 0 0
0 0 0 0 0 0 0 0 0 0 0
0 0 0 0 0 0 0 0 0 0 0
0 0 0 0 0 0 0 0 0 0 0
0 0 0 0 0 0 0 0 0 0 0
0 0 0 0 0 0 0 0 0 0 0
0 0 0 0 0 0 0 0 0 0 0
0 0 0 0 0 0 0 0 0 0 0
0 0 0 0 0 0 0 0 0 0 0
0 0 0 0 0 0 0 0 0 0 0
0 0 0 0 0 0 0 0 0 0 0
0 0 0 0 0 0 0 0 0 0 0
0 0 0 0 0 0 0 0 0 0 0
0 0 0 0 0 0 0 0 0 0 0
0 0 0 0 0 0 0 0 0 0 0
0 0 0 0 0 0 0 0 0 0 0
0 0 0 0 0 0 0 0 0 0 0
0 0 0 0 0 0 0 0 0 0 0
0 0 0 0 0 0 0 0 0 0 0
0 0 0 0 0 0 0 0 0 0 0
0 0 0 0 0 0 0 0 0 0 0
0 0 0 0 0 0 0 0 0 0 0
0 0 0 0 0 0 0 0 0 0 0
0 0 0 0 0 0 0 0 0 0 0
0 0 0 0 0 0 0 0 0 0 0
0 0 0 0 0 0 0 0 0 0 0
0 0 0 0 0 0 0 0 0 0 0
0 0 0 0 0 0 0 0 0 0 0
0 0 0 0 0 0 0 0 0 0 0
0 0 0 0 0 0 0 0 0 0 0
0 0 0 0 0 0 0 0 0 0 0
0 0 0 0 0 0 0 0 0 0 0
0 0 0 0 0 0 0 0 0 0 0
0 0 0 0 0 0 0 0 0 0 0
0 0 0 0 0 0 0 0 0 0 0
0 0 0 0 0 0 0 0 0 0 0
0 0 0 0 0 0 0 0 0 0 0
0 0 0 0 0 0 0 0 0 0 0
0 0 0 0 0 0 0 0 0 0 0
0 0 0 0 0 0 0 0 0 0 0
0 0 0 0 0 0 0 0 0 0 0
0 0 0 0 0 0 0 0 0 0 0