MODE 2
SIZE 11/70
LIMIT 0/40
COLOR LIMIT 4
STARS 2200/4200/6200
POWERUPS 0/0/0/0
7 3 3 7 7 3 3 7 7 3 3
3 3 3 7 3 3 3 7 3 3 3
7 3 3 1 1 3 3 1 1 3 3
7 7 1 1 1 7 1 1 1 7 7
7 2 2 1 1 2 2 1 1 2 2
2 2 2 15 2 2 2 15 2 2 2
7 2 2 6 6 2 2 6 6 2 2
4 4 6 6 6 7 6 6 6 7 7
4 4 4 6 6 4 4 6 6 4 4
4 4 5 5 4 4 4 7 4 4 4
7 7 5 15 5 4 4 5 15 4 4
3 3 5 5 3 3 5 5 5 7 7
3 3 3 7 3 3 3 5 5 3 3
3 3 1 1 3 3 1 1 3 3 3
7 7 1 1 1 7 1 1 1 3 3
2 2 1 1 2 2 1 1 2 2 7
2 2 2 15 2 2 2 15 2 2 2
2 2 6 6 2 2 6 6 2 2 7
7 7 6 6 6 7 6 6 6 7 7
4 4 6 6 4 4 6 6 4 4 7
4 4 4 7 4 4 4 7 4 4 4
4 4 5 5 4 4 5 5 4 4 7
7 7 5 5 5 7 5 5 5 7 7
0 0 5 5 0 0 5 5 0 0 0
0 0 0 0 0 0 0 0 0 0 0
0 0 0 0 0 0 0 0 0 0 0
0 0 0 0 0 0 0 0 0 0 0
0 0 0 0 0 0 0 0 0 0 0
0 0 0 0 0 0 0 0 0 0 0
0 0 0 0 0 0 0 0 0 0 0
0 0 0 0 0 0 0 0 0 0 0
0 0 0 0 0 0 0 0 0 0 0
0 0 0 0 0 0 0 0 0 0 0
0 0 0 0 0 0 0 0 0 0 0
0 0 0 0 0 0 0 0 0 0 0
0 0 0 0 0 0 0 0 0 0 0
0 0 0 0 0 0 0 0 0 0 0
0 0 0 0 0 0 0 0 0 0 0
0 0 0 0 0 0 0 0 0 0 0
0 0 0 0 0 0 0 0 0 0 0
0 0 0 0 0 0 0 0 0 0 0
0 0 0 0 0 0 0 0 0 0 0
0 0 0 0 0 0 0 0 0 0 0
0 0 0 0 0 0 0 0 0 0 0
0 0 0 0 0 0 0 0 0 0 0
0 0 0 0 0 0 0 0 0 0 0
0 0 0 0 0 0 0 0 0 0 0
0 0 0 0 0 0 0 0 0 0 0
0 0 0 0 0 0 0 0 0 0 0
0 0 0 0 0 0 0 0 0 0 0
0 0 0 0 0 0 0 0 0 0 0
0 0 0 0 0 0 0 0 0 0 0
0 0 0 0 0 0 0 0 0 0 0
0 0 0 0 0 0 0 0 0 0 0
0 0 0 0 0 0 0 0 0 0 0
0 0 0 0 0 0 0 0 0 0 0
0 0 0 0 0 0 0 0 0 0 0
0 0 0 0 0 0 0 0 0 0 0
0 0 0 0 0 0 0 0 0 0 0
0 0 0 0 0 0 0 0 0 0 0
0 0 0 0 0 0 0 0 0 0 0
0 0 0 0 0 0 0 0 0 0 0
0 0 0 0 0 0 0 0 0 0 0
0 0 0 0 0 0 0 0 0 0 0
0 0 0 0 0 0 0 0 0 0 0
0 0 0 0 0 0 0 0 0 0 0
0 0 0 0 0 0 0 0 0 0 0
0 0 0 0 0 0 0 0 0 0 0
0 0 0 0 0 0 0 0 0 0 0
0 0 0 0 0 0 0 0 0 0 0