MODE 2
SIZE 11/70
LIMIT 0/20
COLOR LIMIT 4
STARS 3200/5200/7200
POWERUPS 0/0/1/0
20 20 20 20 20 20 20 20 20 20 20
1 2 2 1 12 12 1 2 2 1 2
1 1 2 1 1 2 1 1 2 1 1
1 12 12 1 2 2 1 12 12 1 2
20 20 20 20 20 20 10 20 20 20 20
4 6 6 4 6 6 4 6 6 4 6
4 4 6 4 4 6 4 4 6 4 4
4 6 6 4 6 6 4 6 6 4 6
20 20 20 10 20 20 20 20 20 20 20
1 2 2 1 2 2 1 2 2 1 2
1 1 2 1 1 2 1 1 2 1 1
1 2 2 1 2 2 1 2 2 1 2
20 20 20 20 20 20 10 20 20 20 20
4 6 6 4 6 6 4 6 6 4 6
4 4 6 4 4 6 4 4 6 4 4
4 6 6 4 6 6 4 6 6 4 6
20 20 20 20 20 20 20 20 20 20 20
1 2 2 1 2 2 1 2 2 1 2
1 1 2 1 1 2 1 1 2 1 1
1 2 2 1 2 2 1 2 2 1 2
20 20 10 20 20 20 20 20 20 20 20
0 0 0 0 0 0 0 0 0 0 0
0 0 0 0 0 0 0 0 0 0 0
0 0 0 0 0 0 0 0 0 0 0
0 0 0 0 0 0 0 0 0 0 0
0 0 0 0 0 0 0 0 0 0 0
0 0 0 0 0 0 0 0 0 0 0
0 0 0 0 0 0 0 0 0 0 0
0 0 0 0 0 0 0 0 0 0 0
0 0 0 0 0 0 0 0 0 0 0
0 0 0 0 0 0 0 0 0 0 0
0 0 0 0 0 0 0 0 0 0 0
0 0 0 0 0 0 0 0 0 0 0
0 0 0 0 0 0 0 0 0 0 0
0 0 0 0 0 0 0 0 0 0 0
0 0 0 0 0 0 0 0 0 0 0
0 0 0 0 0 0 0 0 0 0 0
0 0 0 0 0 0 0 0 0 0 0
0 0 0 0 0 0 0 0 0 0 0
0 0 0 0 0 0 0 0 0 0 0
0 0 0 0 0 0 0 0 0 0 0
0 0 0 0 0 0 0 0 0 0 0
0 0 0 0 0 0 0 0 0 0 0
0 0 0 0 0 0 0 0 0 0 0
0 0 0 0 0 0 0 0 0 0 0
0 0 0 0 0 0 0 0 0 0 0
0 0 0 0 0 0 0 0 0 0 0
0 0 0 0 0 0 0 0 0 0 0
0 0 0 0 0 0 0 0 0 0 0
0 0 0 0 0 0 0 0 0 0 0
0 0 0 0 0 0 0 0 0 0 0
0 0 0 0 0 0 0 0 0 0 0
0 0 0 0 0 0 0 0 0 0 0
0 0 0 0 0 0 0 0 0 0 0
0 0 0 0 0 0 0 0 0 0 0
0 0 0 0 0 0 0 0 0 0 0
0 0 0 0 0 0 0 0 0 0 0
0 0 0 0 0 0 0 0 0 0 0
0 0 0 0 0 0 0 0 0 0 0
0 0 0 0 0 0 0 0 0 0 0
0 0 0 0 0 0 0 0 0 0 0
0 0 0 0 0 0 0 0 0 0 0
0 0 0 0 0 0 0 0 0 0 0
0 0 0 0 0 0 0 0 0 0 0
0 0 0 0 0 0 0 0 0 0 0
0 0 0 0 0 0 0 0 0 0 0
0 0 0 0 0 0 0 0 0 0 0
0 0 0 0 0 0 0 0 0 0 0
0 0 0 0 0 0 0 0 0 0 0
0 0 0 0 0 0 0 0 0 0 0