MODE 2
SIZE 11/70
LIMIT 0/30
COLOR LIMIT 4
STARS 2000/5200/7200
POWERUPS 0/0/1/0
16 1 10 16 1 16 16 1 16 16 1
1 1 4 1 1 4 1 1 4 1 1
6 1 4 4 1 4 4 1 4 4 1
2 5 4 2 5 4 2 5 4 2 5
2 2 5 2 2 10 2 2 5 2 2
2 1 5 2 1 5 2 1 5 2 6
6 1 1 4 1 1 4 1 1 4 6
2 1 4 4 1 4 4 1 4 4 6
2 2 5 4 2 5 4 2 10 4 2
2 6 5 2 2 5 2 2 5 2 2
6 6 6 5 2 6 5 2 6 5 2
1 6 10 1 6 6 1 6 6 1 6
1 1 4 1 1 4 1 1 4 1 1
1 4 4 1 4 4 1 4 4 1 6
6 6 4 6 6 4 6 6 4 6 2
6 1 6 6 1 6 6 1 10 2 2
6 1 1 4 1 1 4 1 1 4 2
2 1 4 4 1 4 4 1 4 4 0
2 2 10 4 3 3 4 3 3 4 2
2 1 3 3 1 3 3 1 3 2 2
3 1 1 4 1 1 4 1 1 3 2
3 1 4 4 1 4 4 1 3 3 3
3 3 3 4 3 3 4 3 3 10 3
0 0 0 0 0 0 0 3 3 3 3
0 0 0 0 0 0 0 0 0 0 0
0 0 0 0 0 0 0 0 0 0 0
0 0 0 0 0 0 0 0 0 0 0
0 0 0 0 0 0 0 0 0 0 0
0 0 0 0 0 0 0 0 0 0 0
0 0 0 0 0 0 0 0 0 0 0
0 0 0 0 0 0 0 0 0 0 0
0 0 0 0 0 0 0 0 0 0 0
0 0 0 0 0 0 0 0 0 0 0
0 0 0 0 0 0 0 0 0 0 0
0 0 0 0 0 0 0 0 0 0 0
0 0 0 0 0 0 0 0 0 0 0
0 0 0 0 0 0 0 0 0 0 0
0 0 0 0 0 0 0 0 0 0 0
0 0 0 0 0 0 0 0 0 0 0
0 0 0 0 0 0 0 0 0 0 0
0 0 0 0 0 0 0 0 0 0 0
0 0 0 0 0 0 0 0 0 0 0
0 0 0 0 0 0 0 0 0 0 0
0 0 0 0 0 0 0 0 0 0 0
0 0 0 0 0 0 0 0 0 0 0
0 0 0 0 0 0 0 0 0 0 0
0 0 0 0 0 0 0 0 0 0 0
0 0 0 0 0 0 0 0 0 0 0
0 0 0 0 0 0 0 0 0 0 0
0 0 0 0 0 0 0 0 0 0 0
0 0 0 0 0 0 0 0 0 0 0
0 0 0 0 0 0 0 0 0 0 0
0 0 0 0 0 0 0 0 0 0 0
0 0 0 0 0 0 0 0 0 0 0
0 0 0 0 0 0 0 0 0 0 0
0 0 0 0 0 0 0 0 0 0 0
0 0 0 0 0 0 0 0 0 0 0
0 0 0 0 0 0 0 0 0 0 0
0 0 0 0 0 0 0 0 0 0 0
0 0 0 0 0 0 0 0 0 0 0
0 0 0 0 0 0 0 0 0 0 0
0 0 0 0 0 0 0 0 0 0 0
0 0 0 0 0 0 0 0 0 0 0
0 0 0 0 0 0 0 0 0 0 0
0 0 0 0 0 0 0 0 0 0 0
0 0 0 0 0 0 0 0 0 0 0
0 0 0 0 0 0 0 0 0 0 0
0 0 0 0 0 0 0 0 0 0 0
0 0 0 0 0 0 0 0 0 0 0
0 0 0 0 0 0 0 0 0 0 0