MODE 2
SIZE 11/70
LIMIT 0/30
COLOR LIMIT 4
STARS 3200/5200/7200
POWERUPS 1/1/1/0
5 20 20 5 14 20 20 5 14 20 20
5 1 1 4 4 1 1 4 4 1 1
5 1 1 1 4 1 1 1 4 1 1
5 1 1 5 5 1 1 5 5 1 1
20 20 2 2 20 20 2 2 20 20 5
4 2 2 2 14 2 2 2 14 5 5
4 4 2 2 4 4 2 2 4 4 5
4 20 20 5 4 20 20 5 4 20 20
5 1 1 5 5 1 1 5 5 1 1
1 1 1 14 1 1 1 14 1 1 1
5 1 1 4 4 1 1 4 4 1 1
20 20 5 4 20 20 5 4 20 20 5
5 2 2 5 5 2 2 5 5 2 2
2 2 2 4 2 2 2 4 2 2 2
5 2 2 4 4 2 2 4 4 2 2
5 20 20 4 5 20 20 4 5 20 20
5 1 1 5 5 1 1 5 5 1 1
1 1 1 4 1 1 1 4 1 1 1
5 1 1 4 4 1 1 4 4 1 1
20 20 5 4 20 20 5 4 20 20 0
5 6 6 5 5 6 6 5 5 6 6
6 6 6 2 6 6 6 2 6 6 6
5 6 6 2 2 6 6 2 2 6 6
5 20 20 4 2 20 20 4 2 20 20
5 1 1 4 4 1 1 4 4 1 1
1 1 1 4 1 1 1 4 1 1 1
0 1 1 0 0 1 1 0 0 1 1
0 0 0 0 0 0 0 0 0 0 0
0 0 0 0 0 0 0 0 0 0 0
0 0 0 0 0 0 0 0 0 0 0
0 0 0 0 0 0 0 0 0 0 0
0 0 0 0 0 0 0 0 0 0 0
0 0 0 0 0 0 0 0 0 0 0
0 0 0 0 0 0 0 0 0 0 0
0 0 0 0 0 0 0 0 0 0 0
0 0 0 0 0 0 0 0 0 0 0
0 0 0 0 0 0 0 0 0 0 0
0 0 0 0 0 0 0 0 0 0 0
0 0 0 0 0 0 0 0 0 0 0
0 0 0 0 0 0 0 0 0 0 0
0 0 0 0 0 0 0 0 0 0 0
0 0 0 0 0 0 0 0 0 0 0
0 0 0 0 0 0 0 0 0 0 0
0 0 0 0 0 0 0 0 0 0 0
0 0 0 0 0 0 0 0 0 0 0
0 0 0 0 0 0 0 0 0 0 0
0 0 0 0 0 0 0 0 0 0 0
0 0 0 0 0 0 0 0 0 0 0
0 0 0 0 0 0 0 0 0 0 0
0 0 0 0 0 0 0 0 0 0 0
0 0 0 0 0 0 0 0 0 0 0
0 0 0 0 0 0 0 0 0 0 0
0 0 0 0 0 0 0 0 0 0 0
0 0 0 0 0 0 0 0 0 0 0
0 0 0 0 0 0 0 0 0 0 0
0 0 0 0 0 0 0 0 0 0 0
0 0 0 0 0 0 0 0 0 0 0
0 0 0 0 0 0 0 0 0 0 0
0 0 0 0 0 0 0 0 0 0 0
0 0 0 0 0 0 0 0 0 0 0
0 0 0 0 0 0 0 0 0 0 0
0 0 0 0 0 0 0 0 0 0 0
0 0 0 0 0 0 0 0 0 0 0
0 0 0 0 0 0 0 0 0 0 0
0 0 0 0 0 0 0 0 0 0 0
0 0 0 0 0 0 0 0 0 0 0
0 0 0 0 0 0 0 0 0 0 0
0 0 0 0 0 0 0 0 0 0 0
0 0 0 0 0 0 0 0 0 0 0
0 0 0 0 0 0 0 0 0 0 0