MODE 2
SIZE 11/70
LIMIT 0/30
COLOR LIMIT 4
STARS 3200/5200/7200
POWERUPS 0/0/0/0
1 1 1 7 11 11 11 7 1 1 1
1 1 7 7 1 1 7 7 1 1 7
7 1 7 7 7 1 7 7 7 1 7
4 4 4 0 4 4 4 0 4 4 4
0 4 4 0 0 4 4 0 0 4 4
0 4 0 0 0 4 0 0 0 4 0
2 2 2 7 2 2 2 7 2 2 2
2 2 7 7 2 2 7 7 2 2 7
7 2 7 7 7 2 7 7 7 2 7
5 5 5 0 5 5 5 0 5 5 5
0 5 5 0 0 5 5 0 0 5 5
0 5 0 0 0 5 0 0 0 5 0
6 6 6 7 6 6 6 7 6 6 6
6 6 7 7 6 6 7 7 6 6 7
7 6 7 7 7 6 7 7 7 6 7
3 3 3 0 3 3 3 0 3 3 3
0 3 3 0 0 3 3 0 0 3 3
0 3 0 0 0 3 0 0 0 3 0
1 1 1 7 11 11 11 7 1 1 1
1 1 7 7 1 1 7 7 1 1 7
7 1 7 7 7 1 7 7 7 1 7
4 4 4 0 4 4 4 0 4 4 4
0 4 4 0 0 4 4 0 0 4 4
0 4 0 0 0 4 0 0 0 4 0
0 0 0 0 0 0 0 0 0 0 0
0 0 0 0 0 0 0 0 0 0 0
0 0 0 0 0 0 0 0 0 0 0
0 0 0 0 0 0 0 0 0 0 0
0 0 0 0 0 0 0 0 0 0 0
0 0 0 0 0 0 0 0 0 0 0
0 0 0 0 0 0 0 0 0 0 0
0 0 0 0 0 0 0 0 0 0 0
0 0 0 0 0 0 0 0 0 0 0
0 0 0 0 0 0 0 0 0 0 0
0 0 0 0 0 0 0 0 0 0 0
0 0 0 0 0 0 0 0 0 0 0
0 0 0 0 0 0 0 0 0 0 0
0 0 0 0 0 0 0 0 0 0 0
0 0 0 0 0 0 0 0 0 0 0
0 0 0 0 0 0 0 0 0 0 0
0 0 0 0 0 0 0 0 0 0 0
0 0 0 0 0 0 0 0 0 0 0
0 0 0 0 0 0 0 0 0 0 0
0 0 0 0 0 0 0 0 0 0 0
0 0 0 0 0 0 0 0 0 0 0
0 0 0 0 0 0 0 0 0 0 0
0 0 0 0 0 0 0 0 0 0 0
0 0 0 0 0 0 0 0 0 0 0
0 0 0 0 0 0 0 0 0 0 0
0 0 0 0 0 0 0 0 0 0 0
0 0 0 0 0 0 0 0 0 0 0
0 0 0 0 0 0 0 0 0 0 0
0 0 0 0 0 0 0 0 0 0 0
0 0 0 0 0 0 0 0 0 0 0
0 0 0 0 0 0 0 0 0 0 0
0 0 0 0 0 0 0 0 0 0 0
0 0 0 0 0 0 0 0 0 0 0
0 0 0 0 0 0 0 0 0 0 0
0 0 0 0 0 0 0 0 0 0 0
0 0 0 0 0 0 0 0 0 0 0
0 0 0 0 0 0 0 0 0 0 0
0 0 0 0 0 0 0 0 0 0 0
0 0 0 0 0 0 0 0 0 0 0
0 0 0 0 0 0 0 0 0 0 0
0 0 0 0 0 0 0 0 0 0 0
0 0 0 0 0 0 0 0 0 0 0
0 0 0 0 0 0 0 0 0 0 0
0 0 0 0 0 0 0 0 0 0 0
0 0 0 0 0 0 0 0 0 0 0
0 0 0 0 0 0 0 0 0 0 0