MODE 2
SIZE 11/70
LIMIT 0/25
COLOR LIMIT 4
STARS 3200/5200/7200
POWERUPS 0/0/0/0
2 2 2 2 10 12 12 12 12 12 12
1 1 1 3 0 4 0 3 1 1 1
1 1 1 3 0 4 4 0 3 1 1
1 1 1 3 0 4 0 3 1 1 1
2 2 2 2 2 2 10 2 2 2 2
0 4 0 3 1 1 3 0 4 0 0
0 4 4 0 3 1 3 0 4 4 0
0 4 0 3 1 1 3 0 4 0 0
2 2 10 2 2 2 2 2 2 2 2
0 6 5 5 3 3 5 5 6 0 0
0 6 6 5 3 3 3 5 6 6 0
0 6 5 5 3 3 5 5 6 0 0
2 2 2 2 2 2 2 2 10 2 2
1 1 3 0 4 4 0 3 1 1 1
1 1 1 3 4 4 4 0 3 1 1
1 1 3 0 4 4 0 3 1 1 1
2 2 10 2 2 2 2 2 2 2 2
6 4 6 6 3 3 6 6 4 6 6
6 4 4 6 3 3 3 6 4 4 6
6 4 6 6 3 3 6 6 4 6 6
2 2 2 2 2 2 2 2 2 2 2
6 6 0 3 1 1 3 0 6 6 0
6 6 6 3 1 1 1 3 6 6 6
6 6 0 3 1 1 3 0 6 6 0
2 2 2 2 2 2 2 2 2 2 2
0 0 0 0 0 0 0 0 0 0 0
0 0 0 0 0 0 0 0 0 0 0
0 0 0 0 0 0 0 0 0 0 0
0 0 0 0 0 0 0 0 0 0 0
0 0 0 0 0 0 0 0 0 0 0
0 0 0 0 0 0 0 0 0 0 0
0 0 0 0 0 0 0 0 0 0 0
0 0 0 0 0 0 0 0 0 0 0
0 0 0 0 0 0 0 0 0 0 0
0 0 0 0 0 0 0 0 0 0 0
0 0 0 0 0 0 0 0 0 0 0
0 0 0 0 0 0 0 0 0 0 0
0 0 0 0 0 0 0 0 0 0 0
0 0 0 0 0 0 0 0 0 0 0
0 0 0 0 0 0 0 0 0 0 0
0 0 0 0 0 0 0 0 0 0 0
0 0 0 0 0 0 0 0 0 0 0
0 0 0 0 0 0 0 0 0 0 0
0 0 0 0 0 0 0 0 0 0 0
0 0 0 0 0 0 0 0 0 0 0
0 0 0 0 0 0 0 0 0 0 0
0 0 0 0 0 0 0 0 0 0 0
0 0 0 0 0 0 0 0 0 0 0
0 0 0 0 0 0 0 0 0 0 0
0 0 0 0 0 0 0 0 0 0 0
0 0 0 0 0 0 0 0 0 0 0
0 0 0 0 0 0 0 0 0 0 0
0 0 0 0 0 0 0 0 0 0 0
0 0 0 0 0 0 0 0 0 0 0
0 0 0 0 0 0 0 0 0 0 0
0 0 0 0 0 0 0 0 0 0 0
0 0 0 0 0 0 0 0 0 0 0
0 0 0 0 0 0 0 0 0 0 0
0 0 0 0 0 0 0 0 0 0 0
0 0 0 0 0 0 0 0 0 0 0
0 0 0 0 0 0 0 0 0 0 0
0 0 0 0 0 0 0 0 0 0 0
0 0 0 0 0 0 0 0 0 0 0
0 0 0 0 0 0 0 0 0 0 0
0 0 0 0 0 0 0 0 0 0 0
0 0 0 0 0 0 0 0 0 0 0
0 0 0 0 0 0 0 0 0 0 0
0 0 0 0 0 0 0 0 0 0 0
0 0 0 0 0 0 0 0 0 0 0
0 0 0 0 0 0 0 0 0 0 0