MODE 2
SIZE 11/70
LIMIT 0/30
COLOR LIMIT 4
STARS 2200/5200/7200
POWERUPS 1/0/0/0
7 4 4 1 1 12 12 1 1 4 4
4 4 4 1 1 12 1 1 4 4 4
7 4 4 1 1 12 12 1 1 4 4
6 6 3 3 5 5 3 3 6 6 7
6 6 6 9 3 5 3 3 6 6 6
6 6 3 3 5 5 3 3 6 6 7
7 4 4 1 1 2 2 1 1 4 4
4 4 4 1 1 2 1 1 4 4 4
7 4 4 1 1 2 2 1 1 4 4
6 6 3 3 5 5 3 3 6 6 7
6 6 6 3 3 5 3 9 6 6 6
6 6 3 3 5 5 3 3 6 6 7
7 4 4 1 1 2 2 1 1 4 4
4 4 4 1 1 2 1 1 4 4 4
7 4 4 1 1 2 2 1 1 4 4
6 6 3 3 5 5 3 3 6 6 7
6 6 6 9 3 5 3 3 6 6 6
6 6 3 3 5 5 3 3 6 6 7
7 4 4 1 1 2 2 1 1 4 4
4 4 4 1 1 2 1 1 4 4 4
7 4 4 1 1 2 2 1 1 4 4
0 0 0 0 0 0 0 0 0 0 0
0 0 0 0 0 0 0 0 0 0 0
0 0 0 0 0 0 0 0 0 0 0
0 0 0 0 0 0 0 0 0 0 0
0 0 0 0 0 0 0 0 0 0 0
0 0 0 0 0 0 0 0 0 0 0
0 0 0 0 0 0 0 0 0 0 0
0 0 0 0 0 0 0 0 0 0 0
0 0 0 0 0 0 0 0 0 0 0
0 0 0 0 0 0 0 0 0 0 0
0 0 0 0 0 0 0 0 0 0 0
0 0 0 0 0 0 0 0 0 0 0
0 0 0 0 0 0 0 0 0 0 0
0 0 0 0 0 0 0 0 0 0 0
0 0 0 0 0 0 0 0 0 0 0
0 0 0 0 0 0 0 0 0 0 0
0 0 0 0 0 0 0 0 0 0 0
0 0 0 0 0 0 0 0 0 0 0
0 0 0 0 0 0 0 0 0 0 0
0 0 0 0 0 0 0 0 0 0 0
0 0 0 0 0 0 0 0 0 0 0
0 0 0 0 0 0 0 0 0 0 0
0 0 0 0 0 0 0 0 0 0 0
0 0 0 0 0 0 0 0 0 0 0
0 0 0 0 0 0 0 0 0 0 0
0 0 0 0 0 0 0 0 0 0 0
0 0 0 0 0 0 0 0 0 0 0
0 0 0 0 0 0 0 0 0 0 0
0 0 0 0 0 0 0 0 0 0 0
0 0 0 0 0 0 0 0 0 0 0
0 0 0 0 0 0 0 0 0 0 0
0 0 0 0 0 0 0 0 0 0 0
0 0 0 0 0 0 0 0 0 0 0
0 0 0 0 0 0 0 0 0 0 0
0 0 0 0 0 0 0 0 0 0 0
0 0 0 0 0 0 0 0 0 0 0
0 0 0 0 0 0 0 0 0 0 0
0 0 0 0 0 0 0 0 0 0 0
0 0 0 0 0 0 0 0 0 0 0
0 0 0 0 0 0 0 0 0 0 0
0 0 0 0 0 0 0 0 0 0 0
0 0 0 0 0 0 0 0 0 0 0
0 0 0 0 0 0 0 0 0 0 0
0 0 0 0 0 0 0 0 0 0 0
0 0 0 0 0 0 0 0 0 0 0
0 0 0 0 0 0 0 0 0 0 0
0 0 0 0 0 0 0 0 0 0 0
0 0 0 0 0 0 0 0 0 0 0
0 0 0 0 0 0 0 0 0 0 0