MODE 2
SIZE 11/70
LIMIT 0/25
COLOR LIMIT 4
STARS 2000/5200/7200
POWERUPS 1/0/0/0
4 1 4 1 14 1 4 1 4 1 4
4 1 4 1 14 1 4 1 4 1 4
4 1 4 1 14 1 4 1 4 1 4
6 1 6 1 6 1 6 1 6 1 6
6 1 6 1 6 1 6 1 6 1 6
6 1 6 1 6 1 6 1 6 1 6
5 3 5 3 5 3 10 3 5 3 5
5 3 5 3 5 3 5 3 5 3 5
5 3 5 3 5 3 5 3 5 3 5
1 3 1 3 1 3 1 3 1 3 1
1 3 1 3 1 3 1 3 1 3 1
1 3 1 3 1 3 1 3 1 3 1
2 5 2 5 10 5 2 5 2 5 2
2 5 2 5 2 5 2 5 2 5 2
2 5 2 5 2 5 2 5 2 5 2
4 5 4 5 14 5 4 5 4 5 4
4 5 4 5 14 5 4 5 4 5 4
4 5 4 5 14 5 4 5 4 5 4
6 1 6 1 6 1 6 10 6 1 6
6 1 6 1 6 1 6 1 6 1 6
6 1 6 1 6 1 6 1 6 1 6
5 1 5 1 5 1 5 1 5 1 5
5 1 5 1 5 1 5 1 5 1 5
5 1 5 1 5 1 5 1 5 1 5
0 0 0 0 0 0 0 0 0 0 0
0 0 0 0 0 0 0 0 0 0 0
0 0 0 0 0 0 0 0 0 0 0
0 0 0 0 0 0 0 0 0 0 0
0 0 0 0 0 0 0 0 0 0 0
0 0 0 0 0 0 0 0 0 0 0
0 0 0 0 0 0 0 0 0 0 0
0 0 0 0 0 0 0 0 0 0 0
0 0 0 0 0 0 0 0 0 0 0
0 0 0 0 0 0 0 0 0 0 0
0 0 0 0 0 0 0 0 0 0 0
0 0 0 0 0 0 0 0 0 0 0
0 0 0 0 0 0 0 0 0 0 0
0 0 0 0 0 0 0 0 0 0 0
0 0 0 0 0 0 0 0 0 0 0
0 0 0 0 0 0 0 0 0 0 0
0 0 0 0 0 0 0 0 0 0 0
0 0 0 0 0 0 0 0 0 0 0
0 0 0 0 0 0 0 0 0 0 0
0 0 0 0 0 0 0 0 0 0 0
0 0 0 0 0 0 0 0 0 0 0
0 0 0 0 0 0 0 0 0 0 0
0 0 0 0 0 0 0 0 0 0 0
0 0 0 0 0 0 0 0 0 0 0
0 0 0 0 0 0 0 0 0 0 0
0 0 0 0 0 0 0 0 0 0 0
0 0 0 0 0 0 0 0 0 0 0
0 0 0 0 0 0 0 0 0 0 0
0 0 0 0 0 0 0 0 0 0 0
0 0 0 0 0 0 0 0 0 0 0
0 0 0 0 0 0 0 0 0 0 0
0 0 0 0 0 0 0 0 0 0 0
0 0 0 0 0 0 0 0 0 0 0
0 0 0 0 0 0 0 0 0 0 0
0 0 0 0 0 0 0 0 0 0 0
0 0 0 0 0 0 0 0 0 0 0
0 0 0 0 0 0 0 0 0 0 0
0 0 0 0 0 0 0 0 0 0 0
0 0 0 0 0 0 0 0 0 0 0
0 0 0 0 0 0 0 0 0 0 0
0 0 0 0 0 0 0 0 0 0 0
0 0 0 0 0 0 0 0 0 0 0
0 0 0 0 0 0 0 0 0 0 0
0 0 0 0 0 0 0 0 0 0 0
0 0 0 0 0 0 0 0 0 0 0
0 0 0 0 0 0 0 0 0 0 0