MODE 2
SIZE 11/70
LIMIT 0/35
COLOR LIMIT 4
STARS 2000/5200/6200
POWERUPS 1/0/0/0
1 3 6 15 7 7 15 6 3 1 2
1 3 6 15 7 15 6 3 1 2 4
2 1 3 6 15 15 6 3 1 2 4
2 1 3 6 5 6 3 1 2 4 4
4 2 1 3 6 6 3 1 2 4 4
7 7 7 7 6 7 7 7 7 7 7
6 2 1 4 7 7 3 4 1 2 6
6 2 1 4 3 3 4 1 2 6 5
5 6 2 1 4 3 4 1 2 6 5
5 6 2 1 4 4 1 2 6 5 3
3 5 6 2 1 4 1 2 6 5 3
3 5 6 2 20 20 2 6 5 3 3
3 3 5 6 20 2 20 6 5 3 3
3 3 5 6 20 20 6 5 3 3 3
3 3 5 2 1 4 1 2 5 3 3
3 5 2 1 4 4 1 2 5 3 3
3 5 2 1 4 7 4 1 2 5 3
5 2 1 6 7 7 6 1 2 5 3
5 2 6 6 7 7 7 6 6 2 5
0 0 0 0 0 0 0 0 0 0 5
0 0 0 0 0 0 0 0 0 0 0
0 0 0 0 0 0 0 0 0 0 0
0 0 0 0 0 0 0 0 0 0 0
0 0 0 0 0 0 0 0 0 0 0
0 0 0 0 0 0 0 0 0 0 0
0 0 0 0 0 0 0 0 0 0 0
0 0 0 0 0 0 0 0 0 0 0
0 0 0 0 0 0 0 0 0 0 0
0 0 0 0 0 0 0 0 0 0 0
0 0 0 0 0 0 0 0 0 0 0
0 0 0 0 0 0 0 0 0 0 0
0 0 0 0 0 0 0 0 0 0 0
0 0 0 0 0 0 0 0 0 0 0
0 0 0 0 0 0 0 0 0 0 0
0 0 0 0 0 0 0 0 0 0 0
0 0 0 0 0 0 0 0 0 0 0
0 0 0 0 0 0 0 0 0 0 0
0 0 0 0 0 0 0 0 0 0 0
0 0 0 0 0 0 0 0 0 0 0
0 0 0 0 0 0 0 0 0 0 0
0 0 0 0 0 0 0 0 0 0 0
0 0 0 0 0 0 0 0 0 0 0
0 0 0 0 0 0 0 0 0 0 0
0 0 0 0 0 0 0 0 0 0 0
0 0 0 0 0 0 0 0 0 0 0
0 0 0 0 0 0 0 0 0 0 0
0 0 0 0 0 0 0 0 0 0 0
0 0 0 0 0 0 0 0 0 0 0
0 0 0 0 0 0 0 0 0 0 0
0 0 0 0 0 0 0 0 0 0 0
0 0 0 0 0 0 0 0 0 0 0
0 0 0 0 0 0 0 0 0 0 0
0 0 0 0 0 0 0 0 0 0 0
0 0 0 0 0 0 0 0 0 0 0
0 0 0 0 0 0 0 0 0 0 0
0 0 0 0 0 0 0 0 0 0 0
0 0 0 0 0 0 0 0 0 0 0
0 0 0 0 0 0 0 0 0 0 0
0 0 0 0 0 0 0 0 0 0 0
0 0 0 0 0 0 0 0 0 0 0
0 0 0 0 0 0 0 0 0 0 0
0 0 0 0 0 0 0 0 0 0 0
0 0 0 0 0 0 0 0 0 0 0
0 0 0 0 0 0 0 0 0 0 0
0 0 0 0 0 0 0 0 0 0 0
0 0 0 0 0 0 0 0 0 0 0
0 0 0 0 0 0 0 0 0 0 0
0 0 0 0 0 0 0 0 0 0 0
0 0 0 0 0 0 0 0 0 0 0
0 0 0 0 0 0 0 0 0 0 0