MODE 2
SIZE 11/70
LIMIT 0/35
COLOR LIMIT 4
STARS 1800/5200/7200
POWERUPS 1/0/1/0
3 3 20 20 11 11 11 20 20 3 3
3 4 4 4 1 1 4 4 4 3 0
3 3 4 4 7 1 7 4 4 3 3
7 7 4 7 2 2 7 4 7 7 7
3 3 20 20 2 2 2 20 20 6 6
3 0 20 7 2 2 7 20 6 6 6
3 3 1 1 7 7 7 1 1 6 6
7 1 11 1 2 2 1 11 1 3 3
3 3 1 1 2 2 2 1 1 0 3
3 0 20 20 2 2 0 20 20 3 3
3 3 4 4 4 6 6 4 4 4 7
6 6 4 4 0 6 0 4 4 7 7
6 6 6 4 0 2 2 0 4 7 7
6 6 20 20 2 2 2 20 20 3 3
3 3 0 20 0 2 2 0 20 0 3
3 0 1 1 0 6 0 1 1 3 3
3 3 1 1 1 6 6 1 1 1 0
7 7 1 1 2 2 0 1 1 3 3
3 3 20 20 2 2 2 20 20 0 3
3 4 4 4 2 2 4 4 4 3 3
3 3 4 4 6 6 6 4 4 6 6
7 7 4 0 6 6 0 4 6 6 6
3 3 20 20 0 6 0 20 20 6 6
3 0 20 0 2 2 0 20 0 3 3
3 3 1 1 2 2 2 1 1 0 3
7 1 1 1 2 2 1 1 1 3 3
7 7 1 1 0 0 0 1 1 7 7
0 0 0 0 0 0 0 0 0 0 0
0 0 0 0 0 0 0 0 0 0 0
0 0 0 0 0 0 0 0 0 0 0
0 0 0 0 0 0 0 0 0 0 0
0 0 0 0 0 0 0 0 0 0 0
0 0 0 0 0 0 0 0 0 0 0
0 0 0 0 0 0 0 0 0 0 0
0 0 0 0 0 0 0 0 0 0 0
0 0 0 0 0 0 0 0 0 0 0
0 0 0 0 0 0 0 0 0 0 0
0 0 0 0 0 0 0 0 0 0 0
0 0 0 0 0 0 0 0 0 0 0
0 0 0 0 0 0 0 0 0 0 0
0 0 0 0 0 0 0 0 0 0 0
0 0 0 0 0 0 0 0 0 0 0
0 0 0 0 0 0 0 0 0 0 0
0 0 0 0 0 0 0 0 0 0 0
0 0 0 0 0 0 0 0 0 0 0
0 0 0 0 0 0 0 0 0 0 0
0 0 0 0 0 0 0 0 0 0 0
0 0 0 0 0 0 0 0 0 0 0
0 0 0 0 0 0 0 0 0 0 0
0 0 0 0 0 0 0 0 0 0 0
0 0 0 0 0 0 0 0 0 0 0
0 0 0 0 0 0 0 0 0 0 0
0 0 0 0 0 0 0 0 0 0 0
0 0 0 0 0 0 0 0 0 0 0
0 0 0 0 0 0 0 0 0 0 0
0 0 0 0 0 0 0 0 0 0 0
0 0 0 0 0 0 0 0 0 0 0
0 0 0 0 0 0 0 0 0 0 0
0 0 0 0 0 0 0 0 0 0 0
0 0 0 0 0 0 0 0 0 0 0
0 0 0 0 0 0 0 0 0 0 0
0 0 0 0 0 0 0 0 0 0 0
0 0 0 0 0 0 0 0 0 0 0
0 0 0 0 0 0 0 0 0 0 0
0 0 0 0 0 0 0 0 0 0 0
0 0 0 0 0 0 0 0 0 0 0
0 0 0 0 0 0 0 0 0 0 0
0 0 0 0 0 0 0 0 0 0 0
0 0 0 0 0 0 0 0 0 0 0
0 0 0 0 0 0 0 0 0 0 0