MODE 2
SIZE 11/70
LIMIT 0/40
COLOR LIMIT 4
STARS 1900/5200/7200
POWERUPS 1/0/0/0
1 1 6 6 4 4 6 6 5 5 4
4 4 6 4 14 4 6 1 5 4 4
4 4 4 1 14 14 1 4 4 6 6
4 4 1 2 2 1 4 14 4 6 1
1 6 6 2 2 2 1 14 14 1 1
1 6 1 2 2 6 6 1 1 6 6
1 4 4 5 5 1 6 1 4 4 6
4 4 4 5 4 4 1 4 4 4 1
1 4 4 1 4 4 4 1 4 4 1
1 2 2 1 4 4 2 2 6 6 1
1 2 2 2 6 6 2 2 2 6 5
1 2 2 1 6 1 2 2 1 5 5
6 6 1 1 2 2 1 4 4 6 6
6 4 4 2 2 2 4 4 4 6 1
1 4 4 4 2 2 6 4 4 5 5
1 4 4 1 1 6 6 1 1 5 1
6 6 3 3 2 2 6 6 3 3 3
6 7 3 2 2 2 6 3 2 2 3
7 2 2 3 2 2 1 1 2 2 2
2 2 2 3 3 1 1 1 2 2 7
7 2 2 1 1 3 1 1 6 6 3
6 6 1 1 1 3 3 3 6 3 3
0 6 7 1 1 0 0 0 0 0 0
0 0 0 0 0 0 0 0 0 0 0
0 0 0 0 0 0 0 0 0 0 0
0 0 0 0 0 0 0 0 0 0 0
0 0 0 0 0 0 0 0 0 0 0
0 0 0 0 0 0 0 0 0 0 0
0 0 0 0 0 0 0 0 0 0 0
0 0 0 0 0 0 0 0 0 0 0
0 0 0 0 0 0 0 0 0 0 0
0 0 0 0 0 0 0 0 0 0 0
0 0 0 0 0 0 0 0 0 0 0
0 0 0 0 0 0 0 0 0 0 0
0 0 0 0 0 0 0 0 0 0 0
0 0 0 0 0 0 0 0 0 0 0
0 0 0 0 0 0 0 0 0 0 0
0 0 0 0 0 0 0 0 0 0 0
0 0 0 0 0 0 0 0 0 0 0
0 0 0 0 0 0 0 0 0 0 0
0 0 0 0 0 0 0 0 0 0 0
0 0 0 0 0 0 0 0 0 0 0
0 0 0 0 0 0 0 0 0 0 0
0 0 0 0 0 0 0 0 0 0 0
0 0 0 0 0 0 0 0 0 0 0
0 0 0 0 0 0 0 0 0 0 0
0 0 0 0 0 0 0 0 0 0 0
0 0 0 0 0 0 0 0 0 0 0
0 0 0 0 0 0 0 0 0 0 0
0 0 0 0 0 0 0 0 0 0 0
0 0 0 0 0 0 0 0 0 0 0
0 0 0 0 0 0 0 0 0 0 0
0 0 0 0 0 0 0 0 0 0 0
0 0 0 0 0 0 0 0 0 0 0
0 0 0 0 0 0 0 0 0 0 0
0 0 0 0 0 0 0 0 0 0 0
0 0 0 0 0 0 0 0 0 0 0
0 0 0 0 0 0 0 0 0 0 0
0 0 0 0 0 0 0 0 0 0 0
0 0 0 0 0 0 0 0 0 0 0
0 0 0 0 0 0 0 0 0 0 0
0 0 0 0 0 0 0 0 0 0 0
0 0 0 0 0 0 0 0 0 0 0
0 0 0 0 0 0 0 0 0 0 0
0 0 0 0 0 0 0 0 0 0 0
0 0 0 0 0 0 0 0 0 0 0
0 0 0 0 0 0 0 0 0 0 0
0 0 0 0 0 0 0 0 0 0 0
0 0 0 0 0 0 0 0 0 0 0
0 0 0 0 0 0 0 0 0 0 0