MODE 2
SIZE 11/70
LIMIT 0/30
COLOR LIMIT 4
STARS 1800/3800/5800
POWERUPS 1/1/1/1
4 1 1 1 2 3 3 2 1 1 1
4 1 1 2 3 3 3 2 1 1 4
7 4 4 2 4 4 2 4 4 2 4
5 5 4 4 13 4 4 7 4 4 7
5 5 5 6 6 13 13 3 3 5 5
5 5 6 6 6 3 3 3 5 5 5
7 2 2 6 6 5 5 3 3 5 5
2 2 2 13 5 10 5 6 6 7 7
7 2 2 13 13 5 5 6 11 6 7
7 5 5 7 10 7 7 6 6 7 7
7 5 5 5 6 6 7 2 2 7 7
7 5 5 6 6 6 2 2 2 7 7
7 2 2 7 6 6 7 2 2 1 1
2 2 2 7 7 1 1 7 1 1 1
7 2 2 7 7 1 1 1 7 1 1
7 1 1 7 7 1 1 3 3 3 3
7 1 1 1 3 3 3 3 3 3 3
7 1 1 3 4 4 3 3 3 3 3
7 3 3 3 4 4 4 3 3 3 3
3 3 3 3 4 4 3 3 4 4 3
3 3 3 5 5 7 2 2 4 4 4
3 3 5 5 5 2 2 2 4 4 3
3 3 3 5 5 7 2 2 3 3 3
0 0 0 0 0 0 0 0 0 0 0
0 0 0 0 0 0 0 0 0 0 0
0 0 0 0 0 0 0 0 0 0 0
0 0 0 0 0 0 0 0 0 0 0
0 0 0 0 0 0 0 0 0 0 0
0 0 0 0 0 0 0 0 0 0 0
0 0 0 0 0 0 0 0 0 0 0
0 0 0 0 0 0 0 0 0 0 0
0 0 0 0 0 0 0 0 0 0 0
0 0 0 0 0 0 0 0 0 0 0
0 0 0 0 0 0 0 0 0 0 0
0 0 0 0 0 0 0 0 0 0 0
0 0 0 0 0 0 0 0 0 0 0
0 0 0 0 0 0 0 0 0 0 0
0 0 0 0 0 0 0 0 0 0 0
0 0 0 0 0 0 0 0 0 0 0
0 0 0 0 0 0 0 0 0 0 0
0 0 0 0 0 0 0 0 0 0 0
0 0 0 0 0 0 0 0 0 0 0
0 0 0 0 0 0 0 0 0 0 0
0 0 0 0 0 0 0 0 0 0 0
0 0 0 0 0 0 0 0 0 0 0
0 0 0 0 0 0 0 0 0 0 0
0 0 0 0 0 0 0 0 0 0 0
0 0 0 0 0 0 0 0 0 0 0
0 0 0 0 0 0 0 0 0 0 0
0 0 0 0 0 0 0 0 0 0 0
0 0 0 0 0 0 0 0 0 0 0
0 0 0 0 0 0 0 0 0 0 0
0 0 0 0 0 0 0 0 0 0 0
0 0 0 0 0 0 0 0 0 0 0
0 0 0 0 0 0 0 0 0 0 0
0 0 0 0 0 0 0 0 0 0 0
0 0 0 0 0 0 0 0 0 0 0
0 0 0 0 0 0 0 0 0 0 0
0 0 0 0 0 0 0 0 0 0 0
0 0 0 0 0 0 0 0 0 0 0
0 0 0 0 0 0 0 0 0 0 0
0 0 0 0 0 0 0 0 0 0 0
0 0 0 0 0 0 0 0 0 0 0
0 0 0 0 0 0 0 0 0 0 0
0 0 0 0 0 0 0 0 0 0 0
0 0 0 0 0 0 0 0 0 0 0
0 0 0 0 0 0 0 0 0 0 0
0 0 0 0 0 0 0 0 0 0 0
0 0 0 0 0 0 0 0 0 0 0
0 0 0 0 0 0 0 0 0 0 0