MODE 2
SIZE 11/70
LIMIT 0/30
COLOR LIMIT 4
STARS 1800/3800/5800
POWERUPS 1/0/1/0
17 16 16 17 17 10 17 17 16 16 17
1 1 1 7 7 7 7 1 1 1 7
7 1 1 7 7 7 7 7 1 1 7
4 6 6 6 4 4 6 6 6 4 6
4 4 6 6 4 4 4 6 6 4 4
4 6 16 16 4 4 16 16 6 4 6
18 18 18 18 18 18 18 18 18 18 18
7 3 7 7 3 7 7 3 7 7 3
7 3 3 7 3 3 7 3 3 7 3
7 3 7 7 3 7 7 3 7 7 3
2 5 5 2 2 5 5 2 2 5 5
5 5 5 2 5 5 5 2 5 5 5
2 5 5 2 2 5 5 2 2 5 5
7 1 1 7 7 1 1 7 7 1 1
7 1 1 1 7 1 1 1 7 1 1
7 1 1 7 7 1 10 7 7 1 1
2 4 4 2 2 4 4 10 2 4 4
4 4 4 2 4 4 4 2 4 4 4
2 4 4 2 2 4 4 2 2 4 4
1 1 1 10 4 1 1 1 1 1 1
2 2 2 2 4 2 2 2 2 2 2
6 6 6 6 4 6 6 6 6 6 6
4 4 4 4 4 4 4 10 4 4 4
5 5 5 5 5 4 5 5 5 5 5
0 0 0 0 0 0 0 0 0 0 0
0 0 0 0 0 0 0 0 0 0 0
0 0 0 0 0 0 0 0 0 0 0
0 0 0 0 0 0 0 0 0 0 0
0 0 0 0 0 0 0 0 0 0 0
0 0 0 0 0 0 0 0 0 0 0
0 0 0 0 0 0 0 0 0 0 0
0 0 0 0 0 0 0 0 0 0 0
0 0 0 0 0 0 0 0 0 0 0
0 0 0 0 0 0 0 0 0 0 0
0 0 0 0 0 0 0 0 0 0 0
0 0 0 0 0 0 0 0 0 0 0
0 0 0 0 0 0 0 0 0 0 0
0 0 0 0 0 0 0 0 0 0 0
0 0 0 0 0 0 0 0 0 0 0
0 0 0 0 0 0 0 0 0 0 0
0 0 0 0 0 0 0 0 0 0 0
0 0 0 0 0 0 0 0 0 0 0
0 0 0 0 0 0 0 0 0 0 0
0 0 0 0 0 0 0 0 0 0 0
0 0 0 0 0 0 0 0 0 0 0
0 0 0 0 0 0 0 0 0 0 0
0 0 0 0 0 0 0 0 0 0 0
0 0 0 0 0 0 0 0 0 0 0
0 0 0 0 0 0 0 0 0 0 0
0 0 0 0 0 0 0 0 0 0 0
0 0 0 0 0 0 0 0 0 0 0
0 0 0 0 0 0 0 0 0 0 0
0 0 0 0 0 0 0 0 0 0 0
0 0 0 0 0 0 0 0 0 0 0
0 0 0 0 0 0 0 0 0 0 0
0 0 0 0 0 0 0 0 0 0 0
0 0 0 0 0 0 0 0 0 0 0
0 0 0 0 0 0 0 0 0 0 0
0 0 0 0 0 0 0 0 0 0 0
0 0 0 0 0 0 0 0 0 0 0
0 0 0 0 0 0 0 0 0 0 0
0 0 0 0 0 0 0 0 0 0 0
0 0 0 0 0 0 0 0 0 0 0
0 0 0 0 0 0 0 0 0 0 0
0 0 0 0 0 0 0 0 0 0 0
0 0 0 0 0 0 0 0 0 0 0
0 0 0 0 0 0 0 0 0 0 0
0 0 0 0 0 0 0 0 0 0 0
0 0 0 0 0 0 0 0 0 0 0
0 0 0 0 0 0 0 0 0 0 0