MODE 2
SIZE 11/70
LIMIT 0/20
COLOR LIMIT 4
STARS 1800/3800/5800
POWERUPS 1/0/0/0
3 3 3 3 3 3 3 3 3 3 3
6 6 6 6 6 6 6 6 6 3 1
5 5 5 5 5 5 5 5 6 3 1
2 2 2 2 2 2 5 6 3 1 4
1 1 1 1 1 2 5 6 3 1 4
4 4 4 1 2 5 6 3 1 4 2
13 13 4 1 2 5 6 3 1 4 2
13 4 1 2 5 6 3 1 4 2 5
13 4 1 2 5 6 3 1 4 2 5
4 1 2 5 6 3 1 4 2 5 3
4 1 2 5 6 3 1 4 2 5 3
1 2 5 6 3 1 4 2 5 3 16
1 2 5 6 3 1 4 2 5 3 16
2 5 6 3 1 4 2 5 3 16 16
2 5 6 3 1 4 2 5 3 16 16
5 6 3 1 4 2 5 3 3 3 3
5 6 3 1 4 2 5 5 5 5 5
6 3 1 4 2 2 2 2 2 2 2
6 17 1 4 4 4 4 4 4 4 4
17 1 1 1 1 1 1 1 1 1 1
5 5 5 7 7 7 7 7 7 5 5
5 5 2 2 2 2 2 2 5 5 5
5 5 2 2 2 2 2 2 2 5 5
0 0 0 0 0 0 0 0 0 0 0
0 0 0 0 0 0 0 0 0 0 0
0 0 0 0 0 0 0 0 0 0 0
0 0 0 0 0 0 0 0 0 0 0
0 0 0 0 0 0 0 0 0 0 0
0 0 0 0 0 0 0 0 0 0 0
0 0 0 0 0 0 0 0 0 0 0
0 0 0 0 0 0 0 0 0 0 0
0 0 0 0 0 0 0 0 0 0 0
0 0 0 0 0 0 0 0 0 0 0
0 0 0 0 0 0 0 0 0 0 0
0 0 0 0 0 0 0 0 0 0 0
0 0 0 0 0 0 0 0 0 0 0
0 0 0 0 0 0 0 0 0 0 0
0 0 0 0 0 0 0 0 0 0 0
0 0 0 0 0 0 0 0 0 0 0
0 0 0 0 0 0 0 0 0 0 0
0 0 0 0 0 0 0 0 0 0 0
0 0 0 0 0 0 0 0 0 0 0
0 0 0 0 0 0 0 0 0 0 0
0 0 0 0 0 0 0 0 0 0 0
0 0 0 0 0 0 0 0 0 0 0
0 0 0 0 0 0 0 0 0 0 0
0 0 0 0 0 0 0 0 0 0 0
0 0 0 0 0 0 0 0 0 0 0
0 0 0 0 0 0 0 0 0 0 0
0 0 0 0 0 0 0 0 0 0 0
0 0 0 0 0 0 0 0 0 0 0
0 0 0 0 0 0 0 0 0 0 0
0 0 0 0 0 0 0 0 0 0 0
0 0 0 0 0 0 0 0 0 0 0
0 0 0 0 0 0 0 0 0 0 0
0 0 0 0 0 0 0 0 0 0 0
0 0 0 0 0 0 0 0 0 0 0
0 0 0 0 0 0 0 0 0 0 0
0 0 0 0 0 0 0 0 0 0 0
0 0 0 0 0 0 0 0 0 0 0
0 0 0 0 0 0 0 0 0 0 0
0 0 0 0 0 0 0 0 0 0 0
0 0 0 0 0 0 0 0 0 0 0
0 0 0 0 0 0 0 0 0 0 0
0 0 0 0 0 0 0 0 0 0 0
0 0 0 0 0 0 0 0 0 0 0
0 0 0 0 0 0 0 0 0 0 0
0 0 0 0 0 0 0 0 0 0 0
0 0 0 0 0 0 0 0 0 0 0
0 0 0 0 0 0 0 0 0 0 0