MODE 2
SIZE 11/70
LIMIT 0/20
COLOR LIMIT 4
STARS 1800/3800/5800
POWERUPS 1/0/0/0
0 20 20 0 0 13 0 0 20 20 0
0 1 0 0 13 13 0 0 1 0 0
0 1 1 0 0 13 0 0 1 1 0
0 1 6 6 20 20 6 6 1 0 0
0 0 0 0 0 4 0 0 0 0 0
0 0 0 0 4 4 0 0 0 0 0
0 20 20 13 13 4 13 13 20 20 0
0 1 0 0 0 0 0 0 1 0 0
0 1 1 0 0 0 0 0 1 1 0
0 1 6 6 20 20 6 6 1 0 0
0 0 0 0 0 4 0 0 0 0 0
0 0 0 0 4 4 0 0 0 0 0
0 0 0 0 0 4 0 0 0 0 0
0 20 20 3 3 3 3 3 20 20 0
0 0 2 0 0 0 0 0 0 2 0
0 2 2 0 0 0 0 0 2 2 0
0 0 2 1 1 20 20 1 1 2 0
0 0 0 0 0 5 0 0 0 0 0
0 0 0 0 0 5 5 0 0 0 0
0 20 20 4 4 5 4 4 20 20 0
0 0 6 0 0 0 0 0 0 6 0
0 6 6 0 0 0 0 0 6 6 0
0 0 6 1 1 20 20 1 1 6 0
0 0 0 0 0 3 0 0 0 0 0
0 0 0 0 0 3 3 0 0 0 0
0 20 20 4 4 3 4 4 20 20 0
0 0 5 0 0 0 0 0 0 5 0
0 5 5 0 0 0 0 0 5 5 0
0 0 5 1 1 20 20 1 1 5 0
0 0 0 0 0 3 0 0 0 0 0
0 0 0 0 0 3 3 0 0 0 0
0 0 0 0 0 3 0 0 0 0 0
0 0 0 0 0 0 0 0 0 0 0
0 0 0 0 0 0 0 0 0 0 0
0 0 0 0 0 0 0 0 0 0 0
0 0 0 0 0 0 0 0 0 0 0
0 0 0 0 0 0 0 0 0 0 0
0 0 0 0 0 0 0 0 0 0 0
0 0 0 0 0 0 0 0 0 0 0
0 0 0 0 0 0 0 0 0 0 0
0 0 0 0 0 0 0 0 0 0 0
0 0 0 0 0 0 0 0 0 0 0
0 0 0 0 0 0 0 0 0 0 0
0 0 0 0 0 0 0 0 0 0 0
0 0 0 0 0 0 0 0 0 0 0
0 0 0 0 0 0 0 0 0 0 0
0 0 0 0 0 0 0 0 0 0 0
0 0 0 0 0 0 0 0 0 0 0
0 0 0 0 0 0 0 0 0 0 0
0 0 0 0 0 0 0 0 0 0 0
0 0 0 0 0 0 0 0 0 0 0
0 0 0 0 0 0 0 0 0 0 0
0 0 0 0 0 0 0 0 0 0 0
0 0 0 0 0 0 0 0 0 0 0
0 0 0 0 0 0 0 0 0 0 0
0 0 0 0 0 0 0 0 0 0 0
0 0 0 0 0 0 0 0 0 0 0
0 0 0 0 0 0 0 0 0 0 0
0 0 0 0 0 0 0 0 0 0 0
0 0 0 0 0 0 0 0 0 0 0
0 0 0 0 0 0 0 0 0 0 0
0 0 0 0 0 0 0 0 0 0 0
0 0 0 0 0 0 0 0 0 0 0
0 0 0 0 0 0 0 0 0 0 0
0 0 0 0 0 0 0 0 0 0 0
0 0 0 0 0 0 0 0 0 0 0
0 0 0 0 0 0 0 0 0 0 0
0 0 0 0 0 0 0 0 0 0 0
0 0 0 0 0 0 0 0 0 0 0
0 0 0 0 0 0 0 0 0 0 0