MODE 2
SIZE 11/70
LIMIT 0/20
COLOR LIMIT 4
STARS 1800/3800/5800
POWERUPS 1/0/0/0
14 14 3 3 20 20 20 3 3 14 14
4 4 0 0 1 1 0 0 4 4 4
4 4 0 0 1 1 1 0 0 4 4
0 0 0 0 1 1 0 0 0 0 0
14 14 20 20 20 2 20 20 20 14 14
4 4 6 6 2 2 6 6 4 4 4
4 4 6 6 6 2 6 6 6 4 4
0 0 6 6 20 20 6 6 0 0 0
5 5 5 5 5 20 5 5 5 5 5
5 20 20 5 3 3 5 5 20 20 5
0 0 6 6 3 3 3 6 6 0 0
0 6 6 6 3 3 6 6 6 0 0
0 0 6 6 1 20 1 6 6 0 0
0 0 0 1 20 20 1 0 0 0 0
0 0 20 20 1 1 1 20 20 0 0
4 4 4 0 2 2 0 4 4 4 0
0 4 4 4 2 2 2 4 4 4 0
0 4 4 3 2 2 3 4 4 0 0
0 0 0 3 3 20 3 3 0 0 0
20 20 1 3 20 20 3 1 20 20 20
0 0 0 1 1 1 1 1 0 0 0
0 0 0 0 1 1 0 0 0 0 0
0 0 0 0 0 1 0 0 0 0 0
0 0 0 0 0 0 0 0 0 0 0
0 0 0 0 0 0 0 0 0 0 0
0 0 0 0 0 0 0 0 0 0 0
0 0 0 0 0 0 0 0 0 0 0
0 0 0 0 0 0 0 0 0 0 0
0 0 0 0 0 0 0 0 0 0 0
0 0 0 0 0 0 0 0 0 0 0
0 0 0 0 0 0 0 0 0 0 0
0 0 0 0 0 0 0 0 0 0 0
0 0 0 0 0 0 0 0 0 0 0
0 0 0 0 0 0 0 0 0 0 0
0 0 0 0 0 0 0 0 0 0 0
0 0 0 0 0 0 0 0 0 0 0
0 0 0 0 0 0 0 0 0 0 0
0 0 0 0 0 0 0 0 0 0 0
0 0 0 0 0 0 0 0 0 0 0
0 0 0 0 0 0 0 0 0 0 0
0 0 0 0 0 0 0 0 0 0 0
0 0 0 0 0 0 0 0 0 0 0
0 0 0 0 0 0 0 0 0 0 0
0 0 0 0 0 0 0 0 0 0 0
0 0 0 0 0 0 0 0 0 0 0
0 0 0 0 0 0 0 0 0 0 0
0 0 0 0 0 0 0 0 0 0 0
0 0 0 0 0 0 0 0 0 0 0
0 0 0 0 0 0 0 0 0 0 0
0 0 0 0 0 0 0 0 0 0 0
0 0 0 0 0 0 0 0 0 0 0
0 0 0 0 0 0 0 0 0 0 0
0 0 0 0 0 0 0 0 0 0 0
0 0 0 0 0 0 0 0 0 0 0
0 0 0 0 0 0 0 0 0 0 0
0 0 0 0 0 0 0 0 0 0 0
0 0 0 0 0 0 0 0 0 0 0
0 0 0 0 0 0 0 0 0 0 0
0 0 0 0 0 0 0 0 0 0 0
0 0 0 0 0 0 0 0 0 0 0
0 0 0 0 0 0 0 0 0 0 0
0 0 0 0 0 0 0 0 0 0 0
0 0 0 0 0 0 0 0 0 0 0
0 0 0 0 0 0 0 0 0 0 0
0 0 0 0 0 0 0 0 0 0 0
0 0 0 0 0 0 0 0 0 0 0
0 0 0 0 0 0 0 0 0 0 0
0 0 0 0 0 0 0 0 0 0 0
0 0 0 0 0 0 0 0 0 0 0
0 0 0 0 0 0 0 0 0 0 0