MODE 2
SIZE 11/70
LIMIT 0/20
COLOR LIMIT 4
STARS 1800/3800/5800
POWERUPS 1/0/0/0
7 7 7 7 7 7 7 2 2 7 7
0 0 0 0 4 4 2 2 2 0 0
0 0 2 2 4 4 4 2 2 0 0
0 2 2 2 14 14 7 7 1 1 0
0 0 2 2 7 7 7 7 1 1 1
0 0 14 14 7 7 2 2 1 1 0
0 0 4 4 4 7 2 2 2 0 0
0 0 4 4 7 7 2 2 0 0 0
0 2 2 7 1 1 7 7 4 4 0
2 2 2 1 1 1 7 14 14 14 0
0 2 2 7 1 1 7 7 4 4 0
0 0 6 6 7 7 1 1 0 0 0
0 0 6 6 6 7 1 1 1 0 0
0 0 6 6 7 7 1 1 0 0 0
0 0 5 5 7 6 6 7 7 0 0
0 5 5 5 6 6 6 5 5 0 0
0 0 5 5 7 6 6 5 5 5 0
0 0 0 3 3 7 7 5 5 0 0
0 0 0 3 3 3 7 7 3 3 0
0 2 2 3 3 7 7 3 3 3 0
0 2 2 2 7 7 2 2 3 3 0
0 2 2 7 7 2 2 2 0 0 0
0 0 0 0 0 0 2 2 0 0 0
0 0 0 0 0 0 0 0 0 0 0
0 0 0 0 0 0 0 0 0 0 0
0 0 0 0 0 0 0 0 0 0 0
0 0 0 0 0 0 0 0 0 0 0
0 0 0 0 0 0 0 0 0 0 0
0 0 0 0 0 0 0 0 0 0 0
0 0 0 0 0 0 0 0 0 0 0
0 0 0 0 0 0 0 0 0 0 0
0 0 0 0 0 0 0 0 0 0 0
0 0 0 0 0 0 0 0 0 0 0
0 0 0 0 0 0 0 0 0 0 0
0 0 0 0 0 0 0 0 0 0 0
0 0 0 0 0 0 0 0 0 0 0
0 0 0 0 0 0 0 0 0 0 0
0 0 0 0 0 0 0 0 0 0 0
0 0 0 0 0 0 0 0 0 0 0
0 0 0 0 0 0 0 0 0 0 0
0 0 0 0 0 0 0 0 0 0 0
0 0 0 0 0 0 0 0 0 0 0
0 0 0 0 0 0 0 0 0 0 0
0 0 0 0 0 0 0 0 0 0 0
0 0 0 0 0 0 0 0 0 0 0
0 0 0 0 0 0 0 0 0 0 0
0 0 0 0 0 0 0 0 0 0 0
0 0 0 0 0 0 0 0 0 0 0
0 0 0 0 0 0 0 0 0 0 0
0 0 0 0 0 0 0 0 0 0 0
0 0 0 0 0 0 0 0 0 0 0
0 0 0 0 0 0 0 0 0 0 0
0 0 0 0 0 0 0 0 0 0 0
0 0 0 0 0 0 0 0 0 0 0
0 0 0 0 0 0 0 0 0 0 0
0 0 0 0 0 0 0 0 0 0 0
0 0 0 0 0 0 0 0 0 0 0
0 0 0 0 0 0 0 0 0 0 0
0 0 0 0 0 0 0 0 0 0 0
0 0 0 0 0 0 0 0 0 0 0
0 0 0 0 0 0 0 0 0 0 0
0 0 0 0 0 0 0 0 0 0 0
0 0 0 0 0 0 0 0 0 0 0
0 0 0 0 0 0 0 0 0 0 0
0 0 0 0 0 0 0 0 0 0 0
0 0 0 0 0 0 0 0 0 0 0
0 0 0 0 0 0 0 0 0 0 0
0 0 0 0 0 0 0 0 0 0 0
0 0 0 0 0 0 0 0 0 0 0
0 0 0 0 0 0 0 0 0 0 0