MODE 2
SIZE 11/70
LIMIT 0/25
COLOR LIMIT 4
STARS 1800/3800/5800
POWERUPS 0/0/1/0
0 4 11 11 1 11 4 11 11 1 0
0 4 0 1 0 0 4 0 1 0 0
0 0 4 1 0 0 0 4 1 0 0
4 18 18 1 4 18 18 1 18 4 18
0 4 0 1 0 4 0 1 0 0 4
0 4 1 0 0 4 1 0 0 0 4
7 7 7 4 7 7 1 4 7 7 1
4 18 18 4 18 1 18 4 18 1 18
0 4 0 0 4 1 0 0 4 1 0
20 4 20 20 20 20 4 20 20 4 20
4 0 0 1 4 0 0 4 0 1 4
4 0 1 2 4 0 0 4 1 0 4
0 4 1 0 2 4 5 2 1 0 5
0 2 0 0 2 5 0 2 0 5 0
0 0 2 0 0 5 0 0 2 5 0
7 7 2 5 7 7 7 7 7 7 7
2 0 0 5 0 2 0 0 5 2 0
2 0 5 0 0 2 0 5 0 2 0
7 2 7 7 7 7 2 5 7 7 2
0 0 5 2 0 0 5 2 0 0 5
0 0 5 0 2 0 5 0 2 0 5
0 5 0 0 2 5 0 0 2 5 0
0 0 0 0 0 0 0 0 0 0 0
0 0 0 0 0 0 0 0 0 0 0
0 0 0 0 0 0 0 0 0 0 0
0 0 0 0 0 0 0 0 0 0 0
0 0 0 0 0 0 0 0 0 0 0
0 0 0 0 0 0 0 0 0 0 0
0 0 0 0 0 0 0 0 0 0 0
0 0 0 0 0 0 0 0 0 0 0
0 0 0 0 0 0 0 0 0 0 0
0 0 0 0 0 0 0 0 0 0 0
0 0 0 0 0 0 0 0 0 0 0
0 0 0 0 0 0 0 0 0 0 0
0 0 0 0 0 0 0 0 0 0 0
0 0 0 0 0 0 0 0 0 0 0
0 0 0 0 0 0 0 0 0 0 0
0 0 0 0 0 0 0 0 0 0 0
0 0 0 0 0 0 0 0 0 0 0
0 0 0 0 0 0 0 0 0 0 0
0 0 0 0 0 0 0 0 0 0 0
0 0 0 0 0 0 0 0 0 0 0
0 0 0 0 0 0 0 0 0 0 0
0 0 0 0 0 0 0 0 0 0 0
0 0 0 0 0 0 0 0 0 0 0
0 0 0 0 0 0 0 0 0 0 0
0 0 0 0 0 0 0 0 0 0 0
0 0 0 0 0 0 0 0 0 0 0
0 0 0 0 0 0 0 0 0 0 0
0 0 0 0 0 0 0 0 0 0 0
0 0 0 0 0 0 0 0 0 0 0
0 0 0 0 0 0 0 0 0 0 0
0 0 0 0 0 0 0 0 0 0 0
0 0 0 0 0 0 0 0 0 0 0
0 0 0 0 0 0 0 0 0 0 0
0 0 0 0 0 0 0 0 0 0 0
0 0 0 0 0 0 0 0 0 0 0
0 0 0 0 0 0 0 0 0 0 0
0 0 0 0 0 0 0 0 0 0 0
0 0 0 0 0 0 0 0 0 0 0
0 0 0 0 0 0 0 0 0 0 0
0 0 0 0 0 0 0 0 0 0 0
0 0 0 0 0 0 0 0 0 0 0
0 0 0 0 0 0 0 0 0 0 0
0 0 0 0 0 0 0 0 0 0 0
0 0 0 0 0 0 0 0 0 0 0
0 0 0 0 0 0 0 0 0 0 0
0 0 0 0 0 0 0 0 0 0 0
0 0 0 0 0 0 0 0 0 0 0
0 0 0 0 0 0 0 0 0 0 0