MODE 2
SIZE 11/70
LIMIT 0/15
COLOR LIMIT 4
STARS 1800/3800/5800
POWERUPS 0/0/0/0
20 20 20 1 1 20 12 12 20 4 4
3 3 1 1 1 12 12 12 4 4 4
3 3 3 1 1 0 12 12 0 4 4
3 3 2 2 20 1 1 20 20 20 20
0 0 2 2 2 1 1 1 4 4 0
0 0 2 2 0 1 1 4 4 4 0
20 20 1 1 20 2 2 20 4 4 20
0 1 1 1 2 2 2 0 0 0 0
0 0 1 1 0 2 2 1 1 0 0
0 0 0 0 0 0 1 1 1 0 0
20 20 20 20 20 2 2 1 1 3 3
0 1 1 0 2 2 2 0 3 3 3
0 1 1 1 0 2 2 0 0 3 3
0 1 1 0 0 0 0 1 1 0 0
20 20 20 20 2 2 20 1 1 1 20
0 0 0 2 2 2 0 1 1 0 0
0 0 1 1 2 2 0 0 2 2 0
0 1 1 1 0 0 0 2 2 2 0
20 20 1 1 20 20 20 20 2 2 20
0 4 4 0 2 2 0 1 1 0 0
0 4 4 4 2 2 2 1 1 1 0
0 4 4 0 2 2 0 1 1 0 0
0 0 0 0 0 0 0 0 0 0 0
0 0 0 0 0 0 0 0 0 0 0
0 0 0 0 0 0 0 0 0 0 0
0 0 0 0 0 0 0 0 0 0 0
0 0 0 0 0 0 0 0 0 0 0
0 0 0 0 0 0 0 0 0 0 0
0 0 0 0 0 0 0 0 0 0 0
0 0 0 0 0 0 0 0 0 0 0
0 0 0 0 0 0 0 0 0 0 0
0 0 0 0 0 0 0 0 0 0 0
0 0 0 0 0 0 0 0 0 0 0
0 0 0 0 0 0 0 0 0 0 0
0 0 0 0 0 0 0 0 0 0 0
0 0 0 0 0 0 0 0 0 0 0
0 0 0 0 0 0 0 0 0 0 0
0 0 0 0 0 0 0 0 0 0 0
0 0 0 0 0 0 0 0 0 0 0
0 0 0 0 0 0 0 0 0 0 0
0 0 0 0 0 0 0 0 0 0 0
0 0 0 0 0 0 0 0 0 0 0
0 0 0 0 0 0 0 0 0 0 0
0 0 0 0 0 0 0 0 0 0 0
0 0 0 0 0 0 0 0 0 0 0
0 0 0 0 0 0 0 0 0 0 0
0 0 0 0 0 0 0 0 0 0 0
0 0 0 0 0 0 0 0 0 0 0
0 0 0 0 0 0 0 0 0 0 0
0 0 0 0 0 0 0 0 0 0 0
0 0 0 0 0 0 0 0 0 0 0
0 0 0 0 0 0 0 0 0 0 0
0 0 0 0 0 0 0 0 0 0 0
0 0 0 0 0 0 0 0 0 0 0
0 0 0 0 0 0 0 0 0 0 0
0 0 0 0 0 0 0 0 0 0 0
0 0 0 0 0 0 0 0 0 0 0
0 0 0 0 0 0 0 0 0 0 0
0 0 0 0 0 0 0 0 0 0 0
0 0 0 0 0 0 0 0 0 0 0
0 0 0 0 0 0 0 0 0 0 0
0 0 0 0 0 0 0 0 0 0 0
0 0 0 0 0 0 0 0 0 0 0
0 0 0 0 0 0 0 0 0 0 0
0 0 0 0 0 0 0 0 0 0 0
0 0 0 0 0 0 0 0 0 0 0
0 0 0 0 0 0 0 0 0 0 0
0 0 0 0 0 0 0 0 0 0 0
0 0 0 0 0 0 0 0 0 0 0
0 0 0 0 0 0 0 0 0 0 0