MODE 2
SIZE 11/70
LIMIT 0/30
COLOR LIMIT 4
STARS 1800/3800/4800
POWERUPS 1/1/1/1
3 3 6 3 3 14 3 3 6 3 3
3 6 6 3 14 14 3 6 6 3 0
4 1 14 14 1 4 4 1 4 4 1
1 1 14 1 1 4 1 1 4 1 1
6 3 3 6 3 3 6 3 3 6 3
6 3 6 6 3 6 6 3 6 6 3
4 1 4 4 1 4 4 1 4 4 1
1 1 4 1 1 4 1 1 4 1 1
3 3 6 3 3 6 3 3 6 3 3
3 6 6 3 6 6 3 6 6 3 0
4 1 4 4 1 4 4 1 4 4 1
1 1 4 1 1 4 1 1 4 1 1
6 3 3 6 3 3 6 3 3 6 3
6 3 6 6 3 6 6 3 6 6 3
4 1 4 4 1 4 4 1 4 4 1
1 1 4 1 1 4 1 1 4 1 1
3 3 6 3 3 6 3 3 6 3 3
3 6 6 3 6 6 3 6 6 3 6
4 1 4 4 1 4 4 1 4 4 1
1 1 4 1 1 4 1 1 4 1 1
3 3 6 3 3 6 3 3 6 3 3
3 6 6 3 6 6 3 6 6 3 6
4 1 4 4 1 4 4 1 4 4 1
1 1 4 1 1 4 1 1 4 1 1
0 0 0 0 0 0 0 0 0 0 0
0 0 0 0 0 0 0 0 0 0 0
0 0 0 0 0 0 0 0 0 0 0
0 0 0 0 0 0 0 0 0 0 0
0 0 0 0 0 0 0 0 0 0 0
0 0 0 0 0 0 0 0 0 0 0
0 0 0 0 0 0 0 0 0 0 0
0 0 0 0 0 0 0 0 0 0 0
0 0 0 0 0 0 0 0 0 0 0
0 0 0 0 0 0 0 0 0 0 0
0 0 0 0 0 0 0 0 0 0 0
0 0 0 0 0 0 0 0 0 0 0
0 0 0 0 0 0 0 0 0 0 0
0 0 0 0 0 0 0 0 0 0 0
0 0 0 0 0 0 0 0 0 0 0
0 0 0 0 0 0 0 0 0 0 0
0 0 0 0 0 0 0 0 0 0 0
0 0 0 0 0 0 0 0 0 0 0
0 0 0 0 0 0 0 0 0 0 0
0 0 0 0 0 0 0 0 0 0 0
0 0 0 0 0 0 0 0 0 0 0
0 0 0 0 0 0 0 0 0 0 0
0 0 0 0 0 0 0 0 0 0 0
0 0 0 0 0 0 0 0 0 0 0
0 0 0 0 0 0 0 0 0 0 0
0 0 0 0 0 0 0 0 0 0 0
0 0 0 0 0 0 0 0 0 0 0
0 0 0 0 0 0 0 0 0 0 0
0 0 0 0 0 0 0 0 0 0 0
0 0 0 0 0 0 0 0 0 0 0
0 0 0 0 0 0 0 0 0 0 0
0 0 0 0 0 0 0 0 0 0 0
0 0 0 0 0 0 0 0 0 0 0
0 0 0 0 0 0 0 0 0 0 0
0 0 0 0 0 0 0 0 0 0 0
0 0 0 0 0 0 0 0 0 0 0
0 0 0 0 0 0 0 0 0 0 0
0 0 0 0 0 0 0 0 0 0 0
0 0 0 0 0 0 0 0 0 0 0
0 0 0 0 0 0 0 0 0 0 0
0 0 0 0 0 0 0 0 0 0 0
0 0 0 0 0 0 0 0 0 0 0
0 0 0 0 0 0 0 0 0 0 0
0 0 0 0 0 0 0 0 0 0 0
0 0 0 0 0 0 0 0 0 0 0
0 0 0 0 0 0 0 0 0 0 0