MODE 2
SIZE 11/70
LIMIT 0/30
COLOR LIMIT 4
STARS 1800/3800/4800
POWERUPS 1/0/0/0
6 20 4 4 4 4 4 20 4 4 6
6 20 1 11 11 11 1 20 1 4 6
6 4 20 2 2 2 2 2 20 1 4
4 1 20 3 3 3 3 3 2 1 4
4 1 2 20 6 6 6 6 3 2 1
1 2 3 20 14 14 14 6 3 2 1
1 2 3 6 20 1 1 4 6 3 2
2 3 6 4 20 1 1 4 6 3 2
1 2 3 6 4 20 1 4 6 3 2
1 2 3 6 4 20 4 6 3 2 4
4 1 2 3 6 6 20 6 3 2 4
4 1 2 3 3 3 20 3 2 4 6
6 4 1 2 2 2 2 20 2 4 6
6 4 1 1 1 1 1 20 4 6 3
3 6 4 4 4 4 4 4 20 6 3
3 6 6 6 6 6 6 6 20 3 2
2 3 3 3 3 3 3 3 3 20 2
2 2 2 2 2 2 2 2 2 20 1
1 1 1 1 1 1 1 1 1 1 20
0 20 4 6 5 20 5 6 4 20 0
0 0 20 4 6 5 5 6 4 20 0
0 0 20 4 6 5 6 4 20 0 0
0 0 0 20 4 6 6 4 20 0 0
0 0 0 20 4 4 4 20 0 0 0
0 0 0 0 20 20 20 20 0 0 0
0 0 0 0 0 0 0 0 0 0 0
0 0 0 0 0 0 0 0 0 0 0
0 0 0 0 0 0 0 0 0 0 0
0 0 0 0 0 0 0 0 0 0 0
0 0 0 0 0 0 0 0 0 0 0
0 0 0 0 0 0 0 0 0 0 0
0 0 0 0 0 0 0 0 0 0 0
0 0 0 0 0 0 0 0 0 0 0
0 0 0 0 0 0 0 0 0 0 0
0 0 0 0 0 0 0 0 0 0 0
0 0 0 0 0 0 0 0 0 0 0
0 0 0 0 0 0 0 0 0 0 0
0 0 0 0 0 0 0 0 0 0 0
0 0 0 0 0 0 0 0 0 0 0
0 0 0 0 0 0 0 0 0 0 0
0 0 0 0 0 0 0 0 0 0 0
0 0 0 0 0 0 0 0 0 0 0
0 0 0 0 0 0 0 0 0 0 0
0 0 0 0 0 0 0 0 0 0 0
0 0 0 0 0 0 0 0 0 0 0
0 0 0 0 0 0 0 0 0 0 0
0 0 0 0 0 0 0 0 0 0 0
0 0 0 0 0 0 0 0 0 0 0
0 0 0 0 0 0 0 0 0 0 0
0 0 0 0 0 0 0 0 0 0 0
0 0 0 0 0 0 0 0 0 0 0
0 0 0 0 0 0 0 0 0 0 0
0 0 0 0 0 0 0 0 0 0 0
0 0 0 0 0 0 0 0 0 0 0
0 0 0 0 0 0 0 0 0 0 0
0 0 0 0 0 0 0 0 0 0 0
0 0 0 0 0 0 0 0 0 0 0
0 0 0 0 0 0 0 0 0 0 0
0 0 0 0 0 0 0 0 0 0 0
0 0 0 0 0 0 0 0 0 0 0
0 0 0 0 0 0 0 0 0 0 0
0 0 0 0 0 0 0 0 0 0 0
0 0 0 0 0 0 0 0 0 0 0
0 0 0 0 0 0 0 0 0 0 0
0 0 0 0 0 0 0 0 0 0 0
0 0 0 0 0 0 0 0 0 0 0
0 0 0 0 0 0 0 0 0 0 0
0 0 0 0 0 0 0 0 0 0 0
0 0 0 0 0 0 0 0 0 0 0
0 0 0 0 0 0 0 0 0 0 0