MODE 2
SIZE 11/70
LIMIT 0/30
COLOR LIMIT 4
STARS 1800/3800/4800
POWERUPS 1/1/1/1
3 5 2 1 4 6 6 4 1 2 5
5 2 1 4 6 13 6 4 1 2 5
20 2 1 4 6 13 13 6 4 1 2
20 1 4 6 3 5 3 6 4 1 20
2 20 4 6 3 5 5 3 6 4 20
1 20 6 3 5 2 5 3 6 20 1
1 4 20 3 5 2 2 5 3 20 4
4 6 20 5 2 1 2 5 20 6 4
4 6 13 20 2 1 1 2 20 13 6
6 13 5 20 1 4 1 20 5 13 6
6 3 5 2 20 4 4 20 2 5 3
3 5 2 1 20 2 20 1 2 5 3
3 5 2 1 20 2 2 20 1 2 5
5 2 1 20 4 4 4 20 1 2 5
5 2 1 20 1 1 1 1 20 1 2
2 2 20 2 2 2 2 2 20 2 2
0 0 20 5 3 20 20 3 5 20 0
0 20 5 3 6 2 6 3 5 20 0
0 20 5 3 6 2 2 6 3 5 20
20 5 3 6 2 4 2 6 3 5 20
20 5 3 6 2 4 4 2 6 3 20
20 3 6 2 4 1 4 2 6 20 5
20 20 6 2 4 1 1 4 2 20 3
3 20 2 4 1 3 1 4 20 6 3
3 6 20 4 1 3 3 1 20 2 6
6 2 20 1 3 3 3 20 4 2 6
0 0 0 0 0 0 0 0 0 0 0
0 0 0 0 0 0 0 0 0 0 0
0 0 0 0 0 0 0 0 0 0 0
0 0 0 0 0 0 0 0 0 0 0
0 0 0 0 0 0 0 0 0 0 0
0 0 0 0 0 0 0 0 0 0 0
0 0 0 0 0 0 0 0 0 0 0
0 0 0 0 0 0 0 0 0 0 0
0 0 0 0 0 0 0 0 0 0 0
0 0 0 0 0 0 0 0 0 0 0
0 0 0 0 0 0 0 0 0 0 0
0 0 0 0 0 0 0 0 0 0 0
0 0 0 0 0 0 0 0 0 0 0
0 0 0 0 0 0 0 0 0 0 0
0 0 0 0 0 0 0 0 0 0 0
0 0 0 0 0 0 0 0 0 0 0
0 0 0 0 0 0 0 0 0 0 0
0 0 0 0 0 0 0 0 0 0 0
0 0 0 0 0 0 0 0 0 0 0
0 0 0 0 0 0 0 0 0 0 0
0 0 0 0 0 0 0 0 0 0 0
0 0 0 0 0 0 0 0 0 0 0
0 0 0 0 0 0 0 0 0 0 0
0 0 0 0 0 0 0 0 0 0 0
0 0 0 0 0 0 0 0 0 0 0
0 0 0 0 0 0 0 0 0 0 0
0 0 0 0 0 0 0 0 0 0 0
0 0 0 0 0 0 0 0 0 0 0
0 0 0 0 0 0 0 0 0 0 0
0 0 0 0 0 0 0 0 0 0 0
0 0 0 0 0 0 0 0 0 0 0
0 0 0 0 0 0 0 0 0 0 0
0 0 0 0 0 0 0 0 0 0 0
0 0 0 0 0 0 0 0 0 0 0
0 0 0 0 0 0 0 0 0 0 0
0 0 0 0 0 0 0 0 0 0 0
0 0 0 0 0 0 0 0 0 0 0
0 0 0 0 0 0 0 0 0 0 0
0 0 0 0 0 0 0 0 0 0 0
0 0 0 0 0 0 0 0 0 0 0
0 0 0 0 0 0 0 0 0 0 0
0 0 0 0 0 0 0 0 0 0 0
0 0 0 0 0 0 0 0 0 0 0
0 0 0 0 0 0 0 0 0 0 0