MODE 2
SIZE 11/70
LIMIT 0/25
COLOR LIMIT 4
STARS 1800/3800/4800
POWERUPS 0/0/0/0
12 0 11 0 14 0 16 0 15 0 13
2 0 1 0 4 0 6 0 5 0 3
0 2 0 1 0 4 0 6 0 5 0
2 0 1 0 4 0 6 0 5 0 3
2 0 1 0 4 0 6 0 5 0 3
0 2 0 1 0 4 0 6 0 5 0
3 0 2 0 1 0 4 0 6 0 5
3 0 2 0 1 0 4 0 6 0 5
3 0 2 0 1 0 4 0 6 0 5
0 2 0 1 0 4 0 6 0 5 0
0 5 0 2 0 1 0 4 0 6 0
0 5 0 2 0 1 0 4 0 6 0
0 0 5 0 2 0 1 0 4 0 6
0 5 0 2 0 1 0 4 0 6 0
0 5 0 2 0 1 0 4 0 6 0
5 0 6 0 2 0 1 0 4 0 0
0 5 0 6 0 2 0 1 0 4 0
0 5 0 6 0 2 0 1 0 4 0
0 5 0 6 0 2 0 1 0 4 0
5 0 6 0 2 0 1 0 4 0 0
5 0 6 0 4 0 2 0 1 0 0
5 0 6 0 4 0 2 0 1 0 0
0 5 0 6 0 4 0 2 0 1 0
5 0 6 0 4 0 2 0 1 0 0
5 0 6 0 4 0 2 0 1 0 0
0 5 0 6 0 4 0 2 0 1 0
3 0 5 0 6 0 4 0 2 0 1
3 0 5 0 6 0 4 0 2 0 1
3 0 5 0 6 0 4 0 2 0 1
0 5 0 6 0 4 0 2 0 1 0
3 5 0 6 0 4 0 1 0 2 0
0 5 0 6 0 4 0 1 0 2 0
3 0 5 0 6 0 4 0 1 0 2
0 5 0 6 0 4 0 1 0 2 0
3 5 0 6 0 4 0 1 0 2 0
0 0 0 0 0 0 0 0 0 0 0
0 0 0 0 0 0 0 0 0 0 0
0 0 0 0 0 0 0 0 0 0 0
0 0 0 0 0 0 0 0 0 0 0
0 0 0 0 0 0 0 0 0 0 0
0 0 0 0 0 0 0 0 0 0 0
0 0 0 0 0 0 0 0 0 0 0
0 0 0 0 0 0 0 0 0 0 0
0 0 0 0 0 0 0 0 0 0 0
0 0 0 0 0 0 0 0 0 0 0
0 0 0 0 0 0 0 0 0 0 0
0 0 0 0 0 0 0 0 0 0 0
0 0 0 0 0 0 0 0 0 0 0
0 0 0 0 0 0 0 0 0 0 0
0 0 0 0 0 0 0 0 0 0 0
0 0 0 0 0 0 0 0 0 0 0
0 0 0 0 0 0 0 0 0 0 0
0 0 0 0 0 0 0 0 0 0 0
0 0 0 0 0 0 0 0 0 0 0
0 0 0 0 0 0 0 0 0 0 0
0 0 0 0 0 0 0 0 0 0 0
0 0 0 0 0 0 0 0 0 0 0
0 0 0 0 0 0 0 0 0 0 0
0 0 0 0 0 0 0 0 0 0 0
0 0 0 0 0 0 0 0 0 0 0
0 0 0 0 0 0 0 0 0 0 0
0 0 0 0 0 0 0 0 0 0 0
0 0 0 0 0 0 0 0 0 0 0
0 0 0 0 0 0 0 0 0 0 0
0 0 0 0 0 0 0 0 0 0 0
0 0 0 0 0 0 0 0 0 0 0
0 0 0 0 0 0 0 0 0 0 0
0 0 0 0 0 0 0 0 0 0 0
0 0 0 0 0 0 0 0 0 0 0
0 0 0 0 0 0 0 0 0 0 0