MODE 2
SIZE 11/70
LIMIT 0/25
COLOR LIMIT 4
STARS 1800/3800/4800
POWERUPS 0/0/0/0
0 0 3 0 0 2 0 0 1 0 0
0 3 3 0 2 2 0 1 1 0 0
0 3 3 3 12 12 12 1 1 1 0
0 4 0 0 6 0 0 5 0 0 0
0 4 4 0 6 6 0 5 5 0 0
4 4 4 16 16 16 5 5 5 0 0
0 0 2 0 0 3 0 0 4 0 0
0 2 2 0 3 3 0 4 4 0 0
0 2 2 2 3 3 3 4 4 4 0
0 0 1 0 0 6 0 0 5 0 0
0 0 1 1 0 6 6 0 5 5 0
0 1 1 1 6 6 6 5 5 5 0
0 0 2 0 0 4 0 0 1 0 0
0 2 2 0 4 4 0 1 1 0 0
0 2 2 2 4 4 4 1 1 1 0
0 0 3 0 0 2 0 0 5 0 0
0 0 3 3 0 2 2 0 5 5 0
0 3 3 3 2 2 2 5 5 5 0
0 0 1 0 0 4 0 0 6 0 0
0 1 1 0 4 4 0 6 6 0 0
0 1 1 1 4 4 4 6 6 6 0
0 0 3 0 0 5 0 0 2 0 0
0 0 3 3 0 5 5 0 2 2 0
0 3 3 3 5 5 5 2 2 2 0
0 0 0 0 0 0 0 0 0 0 0
0 0 0 0 0 0 0 0 0 0 0
0 0 0 0 0 0 0 0 0 0 0
0 0 0 0 0 0 0 0 0 0 0
0 0 0 0 0 0 0 0 0 0 0
0 0 0 0 0 0 0 0 0 0 0
0 0 0 0 0 0 0 0 0 0 0
0 0 0 0 0 0 0 0 0 0 0
0 0 0 0 0 0 0 0 0 0 0
0 0 0 0 0 0 0 0 0 0 0
0 0 0 0 0 0 0 0 0 0 0
0 0 0 0 0 0 0 0 0 0 0
0 0 0 0 0 0 0 0 0 0 0
0 0 0 0 0 0 0 0 0 0 0
0 0 0 0 0 0 0 0 0 0 0
0 0 0 0 0 0 0 0 0 0 0
0 0 0 0 0 0 0 0 0 0 0
0 0 0 0 0 0 0 0 0 0 0
0 0 0 0 0 0 0 0 0 0 0
0 0 0 0 0 0 0 0 0 0 0
0 0 0 0 0 0 0 0 0 0 0
0 0 0 0 0 0 0 0 0 0 0
0 0 0 0 0 0 0 0 0 0 0
0 0 0 0 0 0 0 0 0 0 0
0 0 0 0 0 0 0 0 0 0 0
0 0 0 0 0 0 0 0 0 0 0
0 0 0 0 0 0 0 0 0 0 0
0 0 0 0 0 0 0 0 0 0 0
0 0 0 0 0 0 0 0 0 0 0
0 0 0 0 0 0 0 0 0 0 0
0 0 0 0 0 0 0 0 0 0 0
0 0 0 0 0 0 0 0 0 0 0
0 0 0 0 0 0 0 0 0 0 0
0 0 0 0 0 0 0 0 0 0 0
0 0 0 0 0 0 0 0 0 0 0
0 0 0 0 0 0 0 0 0 0 0
0 0 0 0 0 0 0 0 0 0 0
0 0 0 0 0 0 0 0 0 0 0
0 0 0 0 0 0 0 0 0 0 0
0 0 0 0 0 0 0 0 0 0 0
0 0 0 0 0 0 0 0 0 0 0
0 0 0 0 0 0 0 0 0 0 0
0 0 0 0 0 0 0 0 0 0 0
0 0 0 0 0 0 0 0 0 0 0
0 0 0 0 0 0 0 0 0 0 0
0 0 0 0 0 0 0 0 0 0 0