MODE 2
SIZE 11/70
LIMIT 0/20
COLOR LIMIT 4
STARS 1800/3800/4800
POWERUPS 0/0/1/0
2 2 20 20 15 15 20 20 20 2 2
2 2 0 15 15 15 0 0 2 2 2
2 2 3 3 5 5 3 3 0 2 2
0 3 3 3 0 3 3 3 0 0 0
2 2 3 3 5 5 13 13 0 2 2
2 2 0 5 5 5 0 0 2 2 2
2 2 0 0 5 5 0 0 0 2 2
1 1 20 20 4 4 4 20 1 1 1
1 1 1 0 4 4 4 0 1 1 1
1 1 0 0 4 4 4 0 1 1 1
0 3 6 6 3 0 3 6 6 3 0
3 6 6 6 3 3 6 6 6 3 0
0 3 6 6 3 0 3 6 6 3 0
5 5 20 20 5 5 20 20 20 5 5
5 5 0 0 5 5 5 0 0 5 5
5 5 2 2 5 5 2 2 0 5 5
20 20 2 2 2 0 2 2 2 20 20
1 1 2 2 1 1 2 2 1 1 0
1 1 1 0 1 1 1 0 1 1 1
1 1 0 0 1 1 0 0 1 1 0
0 0 0 0 0 0 0 0 0 0 0
0 0 0 0 0 0 0 0 0 0 0
0 0 0 0 0 0 0 0 0 0 0
0 0 0 0 0 0 0 0 0 0 0
0 0 0 0 0 0 0 0 0 0 0
0 0 0 0 0 0 0 0 0 0 0
0 0 0 0 0 0 0 0 0 0 0
0 0 0 0 0 0 0 0 0 0 0
0 0 0 0 0 0 0 0 0 0 0
0 0 0 0 0 0 0 0 0 0 0
0 0 0 0 0 0 0 0 0 0 0
0 0 0 0 0 0 0 0 0 0 0
0 0 0 0 0 0 0 0 0 0 0
0 0 0 0 0 0 0 0 0 0 0
0 0 0 0 0 0 0 0 0 0 0
0 0 0 0 0 0 0 0 0 0 0
0 0 0 0 0 0 0 0 0 0 0
0 0 0 0 0 0 0 0 0 0 0
0 0 0 0 0 0 0 0 0 0 0
0 0 0 0 0 0 0 0 0 0 0
0 0 0 0 0 0 0 0 0 0 0
0 0 0 0 0 0 0 0 0 0 0
0 0 0 0 0 0 0 0 0 0 0
0 0 0 0 0 0 0 0 0 0 0
0 0 0 0 0 0 0 0 0 0 0
0 0 0 0 0 0 0 0 0 0 0
0 0 0 0 0 0 0 0 0 0 0
0 0 0 0 0 0 0 0 0 0 0
0 0 0 0 0 0 0 0 0 0 0
0 0 0 0 0 0 0 0 0 0 0
0 0 0 0 0 0 0 0 0 0 0
0 0 0 0 0 0 0 0 0 0 0
0 0 0 0 0 0 0 0 0 0 0
0 0 0 0 0 0 0 0 0 0 0
0 0 0 0 0 0 0 0 0 0 0
0 0 0 0 0 0 0 0 0 0 0
0 0 0 0 0 0 0 0 0 0 0
0 0 0 0 0 0 0 0 0 0 0
0 0 0 0 0 0 0 0 0 0 0
0 0 0 0 0 0 0 0 0 0 0
0 0 0 0 0 0 0 0 0 0 0
0 0 0 0 0 0 0 0 0 0 0
0 0 0 0 0 0 0 0 0 0 0
0 0 0 0 0 0 0 0 0 0 0
0 0 0 0 0 0 0 0 0 0 0
0 0 0 0 0 0 0 0 0 0 0
0 0 0 0 0 0 0 0 0 0 0
0 0 0 0 0 0 0 0 0 0 0
0 0 0 0 0 0 0 0 0 0 0
0 0 0 0 0 0 0 0 0 0 0