MODE 2
SIZE 11/70
LIMIT 0/25
COLOR LIMIT 4
STARS 1800/3800/4800
POWERUPS 0/0/0/0
1 0 1 0 11 0 11 0 1 0 1
1 1 0 0 11 11 0 0 1 1 0
0 1 0 4 0 11 0 4 0 1 0
20 20 4 4 20 20 4 4 20 20 20
0 0 4 0 4 0 4 0 4 0 0
2 0 2 0 2 0 2 0 2 0 2
0 2 2 0 0 2 2 0 0 2 2
0 2 0 6 0 2 0 6 0 2 0
20 20 20 6 6 20 20 6 6 20 20
0 0 6 0 6 0 6 0 6 0 0
5 0 5 0 5 0 5 0 5 0 5
5 5 0 0 5 5 0 0 5 5 0
0 5 0 3 0 5 0 3 0 5 0
20 20 3 3 20 20 3 3 20 20 20
0 0 3 0 3 0 3 0 3 0 0
1 0 1 0 1 0 1 0 1 0 1
0 1 1 0 0 1 1 0 0 1 1
0 1 0 4 0 1 0 4 0 1 0
20 20 20 4 4 20 20 4 4 20 20
0 0 4 0 4 0 4 0 4 0 0
2 0 2 0 2 0 2 0 2 0 2
2 2 0 0 2 2 0 0 2 2 0
0 2 0 0 0 2 0 0 0 2 0
0 0 0 0 0 0 0 0 0 0 0
0 0 0 0 0 0 0 0 0 0 0
0 0 0 0 0 0 0 0 0 0 0
0 0 0 0 0 0 0 0 0 0 0
0 0 0 0 0 0 0 0 0 0 0
0 0 0 0 0 0 0 0 0 0 0
0 0 0 0 0 0 0 0 0 0 0
0 0 0 0 0 0 0 0 0 0 0
0 0 0 0 0 0 0 0 0 0 0
0 0 0 0 0 0 0 0 0 0 0
0 0 0 0 0 0 0 0 0 0 0
0 0 0 0 0 0 0 0 0 0 0
0 0 0 0 0 0 0 0 0 0 0
0 0 0 0 0 0 0 0 0 0 0
0 0 0 0 0 0 0 0 0 0 0
0 0 0 0 0 0 0 0 0 0 0
0 0 0 0 0 0 0 0 0 0 0
0 0 0 0 0 0 0 0 0 0 0
0 0 0 0 0 0 0 0 0 0 0
0 0 0 0 0 0 0 0 0 0 0
0 0 0 0 0 0 0 0 0 0 0
0 0 0 0 0 0 0 0 0 0 0
0 0 0 0 0 0 0 0 0 0 0
0 0 0 0 0 0 0 0 0 0 0
0 0 0 0 0 0 0 0 0 0 0
0 0 0 0 0 0 0 0 0 0 0
0 0 0 0 0 0 0 0 0 0 0
0 0 0 0 0 0 0 0 0 0 0
0 0 0 0 0 0 0 0 0 0 0
0 0 0 0 0 0 0 0 0 0 0
0 0 0 0 0 0 0 0 0 0 0
0 0 0 0 0 0 0 0 0 0 0
0 0 0 0 0 0 0 0 0 0 0
0 0 0 0 0 0 0 0 0 0 0
0 0 0 0 0 0 0 0 0 0 0
0 0 0 0 0 0 0 0 0 0 0
0 0 0 0 0 0 0 0 0 0 0
0 0 0 0 0 0 0 0 0 0 0
0 0 0 0 0 0 0 0 0 0 0
0 0 0 0 0 0 0 0 0 0 0
0 0 0 0 0 0 0 0 0 0 0
0 0 0 0 0 0 0 0 0 0 0
0 0 0 0 0 0 0 0 0 0 0
0 0 0 0 0 0 0 0 0 0 0
0 0 0 0 0 0 0 0 0 0 0
0 0 0 0 0 0 0 0 0 0 0
0 0 0 0 0 0 0 0 0 0 0