MODE 2
SIZE 11/70
LIMIT 0/30
COLOR LIMIT 4
STARS 1800/3800/4800
POWERUPS 0/0/0/0
4 4 4 4 4 14 4 4 4 4 4
4 0 0 0 0 0 0 0 0 0 0
0 4 0 0 0 0 0 0 0 0 0
0 4 0 0 0 0 0 0 0 0 0
7 7 4 7 7 7 7 7 7 7 7
6 6 6 6 6 16 6 6 6 6 6
0 0 0 0 0 0 0 0 0 0 6
0 0 0 0 0 0 0 0 0 6 0
0 0 0 0 0 0 0 0 0 6 0
7 7 7 7 7 7 7 7 6 7 7
5 5 5 5 5 15 5 5 5 5 5
5 0 0 0 0 0 0 0 0 0 0
0 5 0 0 0 0 0 0 0 0 0
0 5 0 0 0 0 0 0 0 0 0
7 7 5 7 7 7 7 7 7 7 7
1 1 1 1 1 11 1 1 1 1 1
0 0 0 0 0 0 0 0 0 0 1
0 0 0 0 0 0 0 0 0 1 0
0 0 0 0 0 0 0 0 0 1 0
7 7 7 7 7 7 7 7 1 7 7
3 3 3 3 3 13 3 3 3 3 3
3 0 0 0 0 0 0 0 0 0 0
0 3 0 0 0 0 0 0 0 0 0
0 3 0 0 0 0 0 0 0 0 0
7 7 3 7 7 7 7 7 7 7 7
2 2 2 2 2 12 2 2 2 2 2
0 0 0 0 0 0 0 0 0 0 2
0 0 0 0 0 0 0 0 0 2 0
0 0 0 0 0 0 0 0 0 2 0
7 7 7 7 7 7 7 7 2 7 7
0 0 0 0 0 0 0 0 0 0 0
0 0 0 0 0 0 0 0 0 0 0
0 0 0 0 0 0 0 0 0 0 0
0 0 0 0 0 0 0 0 0 0 0
0 0 0 0 0 0 0 0 0 0 0
0 0 0 0 0 0 0 0 0 0 0
0 0 0 0 0 0 0 0 0 0 0
0 0 0 0 0 0 0 0 0 0 0
0 0 0 0 0 0 0 0 0 0 0
0 0 0 0 0 0 0 0 0 0 0
0 0 0 0 0 0 0 0 0 0 0
0 0 0 0 0 0 0 0 0 0 0
0 0 0 0 0 0 0 0 0 0 0
0 0 0 0 0 0 0 0 0 0 0
0 0 0 0 0 0 0 0 0 0 0
0 0 0 0 0 0 0 0 0 0 0
0 0 0 0 0 0 0 0 0 0 0
0 0 0 0 0 0 0 0 0 0 0
0 0 0 0 0 0 0 0 0 0 0
0 0 0 0 0 0 0 0 0 0 0
0 0 0 0 0 0 0 0 0 0 0
0 0 0 0 0 0 0 0 0 0 0
0 0 0 0 0 0 0 0 0 0 0
0 0 0 0 0 0 0 0 0 0 0
0 0 0 0 0 0 0 0 0 0 0
0 0 0 0 0 0 0 0 0 0 0
0 0 0 0 0 0 0 0 0 0 0
0 0 0 0 0 0 0 0 0 0 0
0 0 0 0 0 0 0 0 0 0 0
0 0 0 0 0 0 0 0 0 0 0
0 0 0 0 0 0 0 0 0 0 0
0 0 0 0 0 0 0 0 0 0 0
0 0 0 0 0 0 0 0 0 0 0
0 0 0 0 0 0 0 0 0 0 0
0 0 0 0 0 0 0 0 0 0 0
0 0 0 0 0 0 0 0 0 0 0
0 0 0 0 0 0 0 0 0 0 0
0 0 0 0 0 0 0 0 0 0 0
0 0 0 0 0 0 0 0 0 0 0
0 0 0 0 0 0 0 0 0 0 0