MODE 2
SIZE 11/70
LIMIT 0/20
COLOR LIMIT 4
STARS 1800/3800/4800
POWERUPS 0/0/0/0
3 3 3 3 3 13 3 3 3 3 3
3 0 0 0 7 7 0 0 0 0 3
3 0 0 0 7 7 7 0 0 0 3
3 0 0 0 7 7 0 0 0 0 3
3 3 3 3 3 3 3 3 3 3 3
5 5 5 5 5 15 5 5 5 5 5
5 0 0 0 0 7 7 0 0 0 5
5 0 0 0 7 7 7 0 0 0 5
5 0 0 0 7 7 7 0 0 0 5
5 5 5 5 5 5 5 5 5 5 5
6 6 6 6 6 16 6 6 6 6 6
6 0 0 0 7 7 0 0 0 0 6
6 0 0 0 7 7 7 0 0 0 6
6 0 0 0 7 7 0 0 0 0 6
6 6 6 6 6 6 6 6 6 6 6
4 4 4 4 4 14 4 4 4 4 4
4 0 0 0 0 7 7 0 0 0 4
4 0 0 0 7 7 7 0 0 0 4
4 0 0 0 7 7 7 0 0 0 4
4 4 4 4 4 4 4 4 4 4 4
1 1 1 1 1 11 1 1 1 1 1
1 0 0 0 7 7 0 0 0 0 1
1 0 0 0 7 7 7 0 0 0 1
1 0 0 0 7 7 0 0 0 0 1
1 1 1 1 1 1 1 1 1 1 1
2 2 2 2 2 12 2 2 2 2 2
2 0 0 0 0 7 7 0 0 0 2
2 0 0 0 7 7 7 0 0 0 2
2 0 0 0 7 7 7 0 0 0 2
2 2 2 2 2 2 2 2 2 2 2
0 0 0 0 0 0 0 0 0 0 0
0 0 0 0 0 0 0 0 0 0 0
0 0 0 0 0 0 0 0 0 0 0
0 0 0 0 0 0 0 0 0 0 0
0 0 0 0 0 0 0 0 0 0 0
0 0 0 0 0 0 0 0 0 0 0
0 0 0 0 0 0 0 0 0 0 0
0 0 0 0 0 0 0 0 0 0 0
0 0 0 0 0 0 0 0 0 0 0
0 0 0 0 0 0 0 0 0 0 0
0 0 0 0 0 0 0 0 0 0 0
0 0 0 0 0 0 0 0 0 0 0
0 0 0 0 0 0 0 0 0 0 0
0 0 0 0 0 0 0 0 0 0 0
0 0 0 0 0 0 0 0 0 0 0
0 0 0 0 0 0 0 0 0 0 0
0 0 0 0 0 0 0 0 0 0 0
0 0 0 0 0 0 0 0 0 0 0
0 0 0 0 0 0 0 0 0 0 0
0 0 0 0 0 0 0 0 0 0 0
0 0 0 0 0 0 0 0 0 0 0
0 0 0 0 0 0 0 0 0 0 0
0 0 0 0 0 0 0 0 0 0 0
0 0 0 0 0 0 0 0 0 0 0
0 0 0 0 0 0 0 0 0 0 0
0 0 0 0 0 0 0 0 0 0 0
0 0 0 0 0 0 0 0 0 0 0
0 0 0 0 0 0 0 0 0 0 0
0 0 0 0 0 0 0 0 0 0 0
0 0 0 0 0 0 0 0 0 0 0
0 0 0 0 0 0 0 0 0 0 0
0 0 0 0 0 0 0 0 0 0 0
0 0 0 0 0 0 0 0 0 0 0
0 0 0 0 0 0 0 0 0 0 0
0 0 0 0 0 0 0 0 0 0 0
0 0 0 0 0 0 0 0 0 0 0
0 0 0 0 0 0 0 0 0 0 0
0 0 0 0 0 0 0 0 0 0 0
0 0 0 0 0 0 0 0 0 0 0
0 0 0 0 0 0 0 0 0 0 0