MODE 2
SIZE 11/70
LIMIT 0/10
COLOR LIMIT 4
STARS 1800/3800/4800
POWERUPS 0/0/0/0
1 20 20 7 7 20 20 20 20 20 20
0 1 0 0 7 0 11 1 0 0 0
0 0 1 0 7 0 11 0 1 0 0
0 0 1 11 7 11 0 0 1 20 20
7 7 7 7 7 0 0 7 0 1 0
7 7 7 7 7 7 7 7 1 7 7
0 0 1 1 1 0 0 7 7 1 1
0 0 1 1 1 1 1 1 1 0 1
4 4 4 4 4 20 20 20 20 20 20
4 4 4 4 4 4 0 4 4 0 0
4 4 0 0 0 0 4 4 4 4 4
0 4 4 4 0 4 4 4 4 4 4
4 4 0 4 4 4 4 4 0 0 0
0 5 5 5 5 5 5 4 4 4 4
20 5 20 20 20 20 20 20 20 20 20
0 5 5 5 5 5 5 5 5 5 0
0 0 0 0 0 0 5 5 5 5 5
5 5 5 5 5 5 5 5 5 5 5
0 0 2 2 2 2 2 2 2 0 0
0 0 2 2 2 2 2 2 0 0 0
0 0 0 2 2 2 2 0 0 0 0
0 0 0 2 2 2 2 0 0 0 0
0 0 0 0 0 0 0 0 0 0 0
0 0 0 0 0 0 0 0 0 0 0
0 0 0 0 0 0 0 0 0 0 0
0 0 0 0 0 0 0 0 0 0 0
0 0 0 0 0 0 0 0 0 0 0
0 0 0 0 0 0 0 0 0 0 0
0 0 0 0 0 0 0 0 0 0 0
0 0 0 0 0 0 0 0 0 0 0
0 0 0 0 0 0 0 0 0 0 0
0 0 0 0 0 0 0 0 0 0 0
0 0 0 0 0 0 0 0 0 0 0
0 0 0 0 0 0 0 0 0 0 0
0 0 0 0 0 0 0 0 0 0 0
0 0 0 0 0 0 0 0 0 0 0
0 0 0 0 0 0 0 0 0 0 0
0 0 0 0 0 0 0 0 0 0 0
0 0 0 0 0 0 0 0 0 0 0
0 0 0 0 0 0 0 0 0 0 0
0 0 0 0 0 0 0 0 0 0 0
0 0 0 0 0 0 0 0 0 0 0
0 0 0 0 0 0 0 0 0 0 0
0 0 0 0 0 0 0 0 0 0 0
0 0 0 0 0 0 0 0 0 0 0
0 0 0 0 0 0 0 0 0 0 0
0 0 0 0 0 0 0 0 0 0 0
0 0 0 0 0 0 0 0 0 0 0
0 0 0 0 0 0 0 0 0 0 0
0 0 0 0 0 0 0 0 0 0 0
0 0 0 0 0 0 0 0 0 0 0
0 0 0 0 0 0 0 0 0 0 0
0 0 0 0 0 0 0 0 0 0 0
0 0 0 0 0 0 0 0 0 0 0
0 0 0 0 0 0 0 0 0 0 0
0 0 0 0 0 0 0 0 0 0 0
0 0 0 0 0 0 0 0 0 0 0
0 0 0 0 0 0 0 0 0 0 0
0 0 0 0 0 0 0 0 0 0 0
0 0 0 0 0 0 0 0 0 0 0
0 0 0 0 0 0 0 0 0 0 0
0 0 0 0 0 0 0 0 0 0 0
0 0 0 0 0 0 0 0 0 0 0
0 0 0 0 0 0 0 0 0 0 0
0 0 0 0 0 0 0 0 0 0 0
0 0 0 0 0 0 0 0 0 0 0
0 0 0 0 0 0 0 0 0 0 0
0 0 0 0 0 0 0 0 0 0 0
0 0 0 0 0 0 0 0 0 0 0
0 0 0 0 0 0 0 0 0 0 0