MODE 2
SIZE 11/70
LIMIT 0/20
COLOR LIMIT 4
STARS 1800/3800/4800
POWERUPS 0/0/0/0
3 3 0 2 2 0 11 11 0 4 4
0 3 0 0 2 0 0 1 0 0 4
5 0 3 3 0 12 12 0 1 1 0
0 0 6 6 0 15 15 0 3 3 0
0 0 6 0 0 5 0 0 3 0 0
6 6 0 5 5 0 3 3 0 0 6
4 4 0 0 1 1 0 2 2 0 0
0 4 0 0 0 1 0 0 2 0 0
0 0 4 4 0 0 1 1 0 2 2
0 0 3 3 0 0 5 5 0 6 6
0 0 3 0 0 0 5 0 0 6 0
3 3 0 0 5 5 0 6 6 0 0
4 4 0 0 2 2 0 0 3 3 0
0 4 0 0 0 2 0 0 0 3 0
0 0 4 4 0 0 2 2 0 0 3
0 0 1 1 0 0 5 5 0 6 6
0 0 1 0 0 0 5 0 0 6 0
1 1 0 0 5 5 0 6 6 0 0
2 2 0 0 4 4 0 0 1 1 0
0 2 0 0 0 4 0 0 0 1 0
0 0 2 2 0 0 4 4 0 0 1
0 0 3 3 0 6 6 0 0 5 5
0 0 3 0 0 6 0 0 0 5 0
3 3 0 6 6 0 0 5 5 0 0
0 0 0 0 0 0 0 0 0 0 0
0 0 0 0 0 0 0 0 0 0 0
0 0 0 0 0 0 0 0 0 0 0
0 0 0 0 0 0 0 0 0 0 0
0 0 0 0 0 0 0 0 0 0 0
0 0 0 0 0 0 0 0 0 0 0
0 0 0 0 0 0 0 0 0 0 0
0 0 0 0 0 0 0 0 0 0 0
0 0 0 0 0 0 0 0 0 0 0
0 0 0 0 0 0 0 0 0 0 0
0 0 0 0 0 0 0 0 0 0 0
0 0 0 0 0 0 0 0 0 0 0
0 0 0 0 0 0 0 0 0 0 0
0 0 0 0 0 0 0 0 0 0 0
0 0 0 0 0 0 0 0 0 0 0
0 0 0 0 0 0 0 0 0 0 0
0 0 0 0 0 0 0 0 0 0 0
0 0 0 0 0 0 0 0 0 0 0
0 0 0 0 0 0 0 0 0 0 0
0 0 0 0 0 0 0 0 0 0 0
0 0 0 0 0 0 0 0 0 0 0
0 0 0 0 0 0 0 0 0 0 0
0 0 0 0 0 0 0 0 0 0 0
0 0 0 0 0 0 0 0 0 0 0
0 0 0 0 0 0 0 0 0 0 0
0 0 0 0 0 0 0 0 0 0 0
0 0 0 0 0 0 0 0 0 0 0
0 0 0 0 0 0 0 0 0 0 0
0 0 0 0 0 0 0 0 0 0 0
0 0 0 0 0 0 0 0 0 0 0
0 0 0 0 0 0 0 0 0 0 0
0 0 0 0 0 0 0 0 0 0 0
0 0 0 0 0 0 0 0 0 0 0
0 0 0 0 0 0 0 0 0 0 0
0 0 0 0 0 0 0 0 0 0 0
0 0 0 0 0 0 0 0 0 0 0
0 0 0 0 0 0 0 0 0 0 0
0 0 0 0 0 0 0 0 0 0 0
0 0 0 0 0 0 0 0 0 0 0
0 0 0 0 0 0 0 0 0 0 0
0 0 0 0 0 0 0 0 0 0 0
0 0 0 0 0 0 0 0 0 0 0
0 0 0 0 0 0 0 0 0 0 0
0 0 0 0 0 0 0 0 0 0 0
0 0 0 0 0 0 0 0 0 0 0
0 0 0 0 0 0 0 0 0 0 0