MODE 2
SIZE 11/70
LIMIT 0/10
COLOR LIMIT 4
STARS 1800/3800/4800
POWERUPS 0/0/0/0
0 0 0 0 2 2 2 0 0 0 0
0 0 0 2 2 2 2 0 0 0 0
0 0 0 2 2 0 2 2 0 0 0
0 0 2 2 0 0 2 2 0 0 0
0 0 2 2 0 0 0 2 2 0 0
0 2 2 12 12 12 12 2 2 0 0
0 2 2 0 0 0 0 0 2 2 0
2 2 0 0 0 0 0 0 2 2 0
2 2 0 0 0 0 0 0 0 2 2
20 20 1 1 1 1 1 20 20 20 20
0 0 1 1 0 0 0 1 0 0 0
0 0 1 0 0 0 1 0 0 0 0
0 0 1 1 1 1 1 0 0 0 0
0 0 1 1 1 1 1 0 0 0 0
0 0 1 1 0 0 0 1 0 0 0
0 0 1 0 0 0 1 0 0 0 0
0 0 1 1 1 1 1 0 0 0 0
20 20 20 4 4 4 4 4 20 20 20
0 0 0 4 4 4 4 4 0 0 0
0 0 4 4 0 0 0 0 0 0 0
0 0 0 4 4 0 0 0 0 0 0
0 0 0 4 0 0 0 0 0 0 0
0 0 0 4 4 0 0 0 0 0 0
0 0 0 4 4 0 0 0 0 0 0
0 0 0 4 4 4 4 4 0 0 0
0 0 0 4 4 4 4 4 0 0 0
20 20 6 6 6 6 6 6 6 20 20
0 0 0 0 6 0 0 6 6 0 0
0 0 0 0 6 6 0 0 6 6 0
0 0 0 0 6 0 0 0 6 6 0
0 0 0 0 6 6 0 0 6 6 0
0 0 0 0 6 0 0 6 6 0 0
0 0 0 0 6 6 0 6 6 0 0
20 6 6 6 6 6 6 6 20 20 20
0 0 0 5 5 5 5 5 5 0 0
0 0 0 5 0 0 0 0 0 0 0
0 0 0 5 0 0 0 0 0 0 0
0 0 0 5 0 0 0 0 0 0 0
0 0 0 5 5 5 5 5 0 0 0
0 0 0 5 0 0 0 0 0 0 0
0 0 0 5 5 0 0 0 0 0 0
0 0 0 5 0 0 0 0 0 0 0
20 20 20 5 5 5 5 5 5 20 20
0 0 0 0 0 0 0 0 0 0 0
0 0 0 0 0 0 0 0 0 0 0
0 0 0 0 0 0 0 0 0 0 0
0 0 0 0 0 0 0 0 0 0 0
0 0 0 0 0 0 0 0 0 0 0
0 0 0 0 0 0 0 0 0 0 0
0 0 0 0 0 0 0 0 0 0 0
0 0 0 0 0 0 0 0 0 0 0
0 0 0 0 0 0 0 0 0 0 0
0 0 0 0 0 0 0 0 0 0 0
0 0 0 0 0 0 0 0 0 0 0
0 0 0 0 0 0 0 0 0 0 0
0 0 0 0 0 0 0 0 0 0 0
0 0 0 0 0 0 0 0 0 0 0
0 0 0 0 0 0 0 0 0 0 0
0 0 0 0 0 0 0 0 0 0 0
0 0 0 0 0 0 0 0 0 0 0
0 0 0 0 0 0 0 0 0 0 0
0 0 0 0 0 0 0 0 0 0 0
0 0 0 0 0 0 0 0 0 0 0
0 0 0 0 0 0 0 0 0 0 0
0 0 0 0 0 0 0 0 0 0 0
0 0 0 0 0 0 0 0 0 0 0
0 0 0 0 0 0 0 0 0 0 0
0 0 0 0 0 0 0 0 0 0 0
0 0 0 0 0 0 0 0 0 0 0
0 0 0 0 0 0 0 0 0 0 0