MODE 2
SIZE 11/70
LIMIT 0/15
COLOR LIMIT 4
STARS 1800/3800/4800
POWERUPS 0/0/0/0
0 0 3 3 1 1 1 6 6 0 0
0 0 0 3 11 11 6 0 0 0 0
0 0 0 0 3 11 6 0 0 0 0
5 5 5 5 3 6 5 5 5 5 5
0 0 0 0 3 11 6 0 0 0 0
0 0 0 3 11 11 6 0 0 0 0
0 0 3 3 1 1 1 6 6 0 0
0 0 2 2 0 0 0 4 4 0 0
0 0 0 0 2 0 0 4 0 0 0
0 0 0 0 2 0 4 0 0 0 0
5 5 5 5 5 2 4 5 5 5 5
0 0 0 0 2 6 4 0 0 0 0
0 0 0 0 2 6 6 4 0 0 0
0 0 2 2 6 5 6 4 4 0 0
6 6 6 6 6 5 5 6 6 6 6
5 5 5 5 5 3 5 5 5 5 5
0 1 3 3 3 3 3 3 3 3 1
0 1 3 4 4 4 4 4 3 1 0
0 0 1 3 2 2 2 2 3 1 0
0 0 1 2 1 1 1 2 1 0 0
0 0 1 2 1 0 0 1 2 1 0
0 1 2 1 0 0 0 1 2 1 0
0 1 1 1 0 0 0 0 1 1 1
20 20 20 20 20 20 20 20 20 20 20
0 0 2 2 2 2 2 2 2 2 0
0 0 0 0 0 0 0 0 0 0 0
0 0 0 0 0 0 0 0 0 0 0
0 0 0 0 0 0 0 0 0 0 0
0 0 0 0 0 0 0 0 0 0 0
0 0 0 0 0 0 0 0 0 0 0
0 0 0 0 0 0 0 0 0 0 0
0 0 0 0 0 0 0 0 0 0 0
0 0 0 0 0 0 0 0 0 0 0
0 0 0 0 0 0 0 0 0 0 0
0 0 0 0 0 0 0 0 0 0 0
0 0 0 0 0 0 0 0 0 0 0
0 0 0 0 0 0 0 0 0 0 0
0 0 0 0 0 0 0 0 0 0 0
0 0 0 0 0 0 0 0 0 0 0
0 0 0 0 0 0 0 0 0 0 0
0 0 0 0 0 0 0 0 0 0 0
0 0 0 0 0 0 0 0 0 0 0
0 0 0 0 0 0 0 0 0 0 0
0 0 0 0 0 0 0 0 0 0 0
0 0 0 0 0 0 0 0 0 0 0
0 0 0 0 0 0 0 0 0 0 0
0 0 0 0 0 0 0 0 0 0 0
0 0 0 0 0 0 0 0 0 0 0
0 0 0 0 0 0 0 0 0 0 0
0 0 0 0 0 0 0 0 0 0 0
0 0 0 0 0 0 0 0 0 0 0
0 0 0 0 0 0 0 0 0 0 0
0 0 0 0 0 0 0 0 0 0 0
0 0 0 0 0 0 0 0 0 0 0
0 0 0 0 0 0 0 0 0 0 0
0 0 0 0 0 0 0 0 0 0 0
0 0 0 0 0 0 0 0 0 0 0
0 0 0 0 0 0 0 0 0 0 0
0 0 0 0 0 0 0 0 0 0 0
0 0 0 0 0 0 0 0 0 0 0
0 0 0 0 0 0 0 0 0 0 0
0 0 0 0 0 0 0 0 0 0 0
0 0 0 0 0 0 0 0 0 0 0
0 0 0 0 0 0 0 0 0 0 0
0 0 0 0 0 0 0 0 0 0 0
0 0 0 0 0 0 0 0 0 0 0
0 0 0 0 0 0 0 0 0 0 0
0 0 0 0 0 0 0 0 0 0 0
0 0 0 0 0 0 0 0 0 0 0
0 0 0 0 0 0 0 0 0 0 0