MODE 2
SIZE 11/70
LIMIT 0/15
COLOR LIMIT 4
STARS 1800/3800/4800
POWERUPS 0/0/0/0
3 3 0 0 0 0 0 0 0 1 1
0 3 3 0 0 0 0 1 1 0 0
0 0 0 13 13 0 1 1 0 0 0
0 0 0 0 3 3 0 0 0 0 0
0 0 0 1 1 0 13 13 0 0 0
0 1 1 0 0 0 0 3 3 0 0
1 1 0 0 0 0 0 0 0 3 3
0 2 2 0 0 0 0 6 6 0 0
0 0 0 2 2 0 6 6 0 0 0
0 0 0 0 2 2 0 0 0 0 0
0 0 0 6 6 0 2 2 0 0 0
0 6 6 0 0 0 0 2 2 0 0
6 6 0 0 0 0 0 0 0 2 2
0 5 5 0 0 0 0 4 4 0 0
0 0 0 5 5 0 4 4 0 0 0
0 0 0 0 5 5 0 0 0 0 0
0 0 0 4 4 0 5 5 0 0 0
0 4 4 0 0 0 0 5 5 0 0
4 4 0 0 0 0 0 0 0 5 5
0 1 1 0 0 0 0 3 3 0 0
0 0 0 1 1 0 3 3 0 0 0
0 0 0 0 1 1 0 0 0 0 0
0 0 0 3 3 0 1 1 0 0 0
0 3 3 0 0 0 0 1 1 0 0
3 3 0 0 0 0 0 0 0 1 1
0 0 0 0 0 0 0 0 0 0 0
0 0 0 0 0 0 0 0 0 0 0
0 0 0 0 0 0 0 0 0 0 0
0 0 0 0 0 0 0 0 0 0 0
0 0 0 0 0 0 0 0 0 0 0
0 0 0 0 0 0 0 0 0 0 0
0 0 0 0 0 0 0 0 0 0 0
0 0 0 0 0 0 0 0 0 0 0
0 0 0 0 0 0 0 0 0 0 0
0 0 0 0 0 0 0 0 0 0 0
0 0 0 0 0 0 0 0 0 0 0
0 0 0 0 0 0 0 0 0 0 0
0 0 0 0 0 0 0 0 0 0 0
0 0 0 0 0 0 0 0 0 0 0
0 0 0 0 0 0 0 0 0 0 0
0 0 0 0 0 0 0 0 0 0 0
0 0 0 0 0 0 0 0 0 0 0
0 0 0 0 0 0 0 0 0 0 0
0 0 0 0 0 0 0 0 0 0 0
0 0 0 0 0 0 0 0 0 0 0
0 0 0 0 0 0 0 0 0 0 0
0 0 0 0 0 0 0 0 0 0 0
0 0 0 0 0 0 0 0 0 0 0
0 0 0 0 0 0 0 0 0 0 0
0 0 0 0 0 0 0 0 0 0 0
0 0 0 0 0 0 0 0 0 0 0
0 0 0 0 0 0 0 0 0 0 0
0 0 0 0 0 0 0 0 0 0 0
0 0 0 0 0 0 0 0 0 0 0
0 0 0 0 0 0 0 0 0 0 0
0 0 0 0 0 0 0 0 0 0 0
0 0 0 0 0 0 0 0 0 0 0
0 0 0 0 0 0 0 0 0 0 0
0 0 0 0 0 0 0 0 0 0 0
0 0 0 0 0 0 0 0 0 0 0
0 0 0 0 0 0 0 0 0 0 0
0 0 0 0 0 0 0 0 0 0 0
0 0 0 0 0 0 0 0 0 0 0
0 0 0 0 0 0 0 0 0 0 0
0 0 0 0 0 0 0 0 0 0 0
0 0 0 0 0 0 0 0 0 0 0
0 0 0 0 0 0 0 0 0 0 0
0 0 0 0 0 0 0 0 0 0 0
0 0 0 0 0 0 0 0 0 0 0
0 0 0 0 0 0 0 0 0 0 0