MODE 2
SIZE 11/70
LIMIT 0/30
COLOR LIMIT 4
STARS 1800/3800/4800
POWERUPS 0/0/1/0
6 0 6 0 15 0 5 0 2 0 2
6 0 6 0 15 0 5 0 2 0 2
0 6 0 6 0 15 0 5 0 2 0
20 20 20 20 20 20 20 20 20 20 20
0 1 0 1 0 14 0 4 0 3 0
1 0 1 0 14 0 4 0 3 0 3
1 0 1 0 14 0 4 0 3 0 3
20 20 20 20 20 20 20 20 20 20 20
6 0 6 0 5 0 5 0 2 0 2
6 0 6 0 5 0 5 0 2 0 2
0 6 0 6 0 5 0 5 0 2 0
20 20 20 20 20 20 20 20 20 20 20
0 1 0 1 0 4 0 4 0 3 0
1 0 1 0 4 0 4 0 3 0 3
1 0 1 0 4 0 4 0 3 0 3
20 20 20 20 20 20 20 20 20 20 20
6 0 6 0 5 0 5 0 2 0 2
6 0 6 0 5 0 5 0 2 0 2
0 6 0 6 0 5 0 5 0 2 0
20 20 20 20 20 20 20 20 20 20 20
0 1 0 1 0 4 0 4 0 3 0
1 0 1 0 4 0 4 0 3 0 3
1 0 1 0 4 0 4 0 3 0 3
0 0 0 0 0 0 0 0 0 0 0
0 0 0 0 0 0 0 0 0 0 0
0 0 0 0 0 0 0 0 0 0 0
0 0 0 0 0 0 0 0 0 0 0
0 0 0 0 0 0 0 0 0 0 0
0 0 0 0 0 0 0 0 0 0 0
0 0 0 0 0 0 0 0 0 0 0
0 0 0 0 0 0 0 0 0 0 0
0 0 0 0 0 0 0 0 0 0 0
0 0 0 0 0 0 0 0 0 0 0
0 0 0 0 0 0 0 0 0 0 0
0 0 0 0 0 0 0 0 0 0 0
0 0 0 0 0 0 0 0 0 0 0
0 0 0 0 0 0 0 0 0 0 0
0 0 0 0 0 0 0 0 0 0 0
0 0 0 0 0 0 0 0 0 0 0
0 0 0 0 0 0 0 0 0 0 0
0 0 0 0 0 0 0 0 0 0 0
0 0 0 0 0 0 0 0 0 0 0
0 0 0 0 0 0 0 0 0 0 0
0 0 0 0 0 0 0 0 0 0 0
0 0 0 0 0 0 0 0 0 0 0
0 0 0 0 0 0 0 0 0 0 0
0 0 0 0 0 0 0 0 0 0 0
0 0 0 0 0 0 0 0 0 0 0
0 0 0 0 0 0 0 0 0 0 0
0 0 0 0 0 0 0 0 0 0 0
0 0 0 0 0 0 0 0 0 0 0
0 0 0 0 0 0 0 0 0 0 0
0 0 0 0 0 0 0 0 0 0 0
0 0 0 0 0 0 0 0 0 0 0
0 0 0 0 0 0 0 0 0 0 0
0 0 0 0 0 0 0 0 0 0 0
0 0 0 0 0 0 0 0 0 0 0
0 0 0 0 0 0 0 0 0 0 0
0 0 0 0 0 0 0 0 0 0 0
0 0 0 0 0 0 0 0 0 0 0
0 0 0 0 0 0 0 0 0 0 0
0 0 0 0 0 0 0 0 0 0 0
0 0 0 0 0 0 0 0 0 0 0
0 0 0 0 0 0 0 0 0 0 0
0 0 0 0 0 0 0 0 0 0 0
0 0 0 0 0 0 0 0 0 0 0
0 0 0 0 0 0 0 0 0 0 0
0 0 0 0 0 0 0 0 0 0 0
0 0 0 0 0 0 0 0 0 0 0
0 0 0 0 0 0 0 0 0 0 0