MODE 2
SIZE 11/70
LIMIT 0/20
COLOR LIMIT 4
STARS 1800/3800/4800
POWERUPS 0/0/0/0
5 0 5 5 0 5 5 0 5 5 0
5 5 0 15 15 0 15 15 0 5 5
6 5 6 6 15 6 6 15 6 6 5
6 6 0 6 6 0 6 6 0 6 6
4 6 4 4 6 4 4 6 4 4 6
4 4 0 4 4 0 4 4 0 4 4
1 4 1 1 4 1 1 4 1 1 4
1 1 0 1 1 0 1 1 0 1 1
2 1 2 2 1 2 2 1 2 2 1
2 2 0 2 2 0 2 2 0 2 2
3 2 3 3 2 3 3 2 3 3 2
3 3 0 3 3 0 3 3 0 3 3
5 3 5 5 3 5 5 3 5 5 3
5 5 0 5 5 0 5 5 0 5 5
6 5 6 6 5 6 6 5 6 6 5
6 6 0 6 6 0 6 6 0 6 6
4 6 4 4 6 4 4 6 4 4 6
4 4 0 4 4 0 4 4 0 4 4
1 4 1 1 4 1 1 4 1 1 4
1 1 0 1 1 0 1 1 0 1 1
2 1 2 2 1 2 2 1 2 2 1
2 2 0 2 2 0 2 2 0 2 2
0 2 0 0 2 0 0 2 0 0 2
0 0 0 0 0 0 0 0 0 0 0
0 0 0 0 0 0 0 0 0 0 0
0 0 0 0 0 0 0 0 0 0 0
0 0 0 0 0 0 0 0 0 0 0
0 0 0 0 0 0 0 0 0 0 0
0 0 0 0 0 0 0 0 0 0 0
0 0 0 0 0 0 0 0 0 0 0
0 0 0 0 0 0 0 0 0 0 0
0 0 0 0 0 0 0 0 0 0 0
0 0 0 0 0 0 0 0 0 0 0
0 0 0 0 0 0 0 0 0 0 0
0 0 0 0 0 0 0 0 0 0 0
0 0 0 0 0 0 0 0 0 0 0
0 0 0 0 0 0 0 0 0 0 0
0 0 0 0 0 0 0 0 0 0 0
0 0 0 0 0 0 0 0 0 0 0
0 0 0 0 0 0 0 0 0 0 0
0 0 0 0 0 0 0 0 0 0 0
0 0 0 0 0 0 0 0 0 0 0
0 0 0 0 0 0 0 0 0 0 0
0 0 0 0 0 0 0 0 0 0 0
0 0 0 0 0 0 0 0 0 0 0
0 0 0 0 0 0 0 0 0 0 0
0 0 0 0 0 0 0 0 0 0 0
0 0 0 0 0 0 0 0 0 0 0
0 0 0 0 0 0 0 0 0 0 0
0 0 0 0 0 0 0 0 0 0 0
0 0 0 0 0 0 0 0 0 0 0
0 0 0 0 0 0 0 0 0 0 0
0 0 0 0 0 0 0 0 0 0 0
0 0 0 0 0 0 0 0 0 0 0
0 0 0 0 0 0 0 0 0 0 0
0 0 0 0 0 0 0 0 0 0 0
0 0 0 0 0 0 0 0 0 0 0
0 0 0 0 0 0 0 0 0 0 0
0 0 0 0 0 0 0 0 0 0 0
0 0 0 0 0 0 0 0 0 0 0
0 0 0 0 0 0 0 0 0 0 0
0 0 0 0 0 0 0 0 0 0 0
0 0 0 0 0 0 0 0 0 0 0
0 0 0 0 0 0 0 0 0 0 0
0 0 0 0 0 0 0 0 0 0 0
0 0 0 0 0 0 0 0 0 0 0
0 0 0 0 0 0 0 0 0 0 0
0 0 0 0 0 0 0 0 0 0 0
0 0 0 0 0 0 0 0 0 0 0
0 0 0 0 0 0 0 0 0 0 0