MODE 2
SIZE 11/70
LIMIT 0/30
COLOR LIMIT 4
STARS 1800/3800/4800
POWERUPS 0/0/0/0
0 4 4 0 0 4 4 0 0 4 4
4 4 4 0 14 14 14 0 4 4 4
0 4 4 5 5 14 14 5 5 4 4
0 0 5 5 5 0 5 5 5 0 0
0 2 2 5 5 2 2 5 5 2 2
2 2 2 0 2 2 2 0 2 2 2
0 2 2 1 1 2 2 1 1 2 2
0 0 1 1 1 0 1 1 1 0 0
0 3 3 1 1 3 3 1 1 3 3
3 3 3 0 3 3 3 0 3 3 3
0 3 3 6 6 3 3 6 6 3 3
5 5 6 6 6 5 6 6 6 5 5
6 6 5 6 6 5 5 6 6 5 6
3 6 5 5 5 6 5 5 5 6 6
1 3 6 6 6 6 6 6 6 6 3
1 3 3 3 3 3 3 3 3 3 1
2 1 1 1 1 1 1 1 1 1 1
2 2 2 2 2 2 2 2 2 2 2
4 4 4 4 4 4 4 4 4 4 4
7 7 7 7 7 7 7 7 7 4 0
0 0 0 0 0 0 0 0 7 4 0
0 0 0 0 0 0 0 7 4 4 4
0 0 0 0 0 0 0 7 7 7 7
0 0 0 0 0 0 0 0 0 0 0
0 0 0 0 0 0 0 0 0 0 0
0 0 0 0 0 0 0 0 0 0 0
0 0 0 0 0 0 0 0 0 0 0
0 0 0 0 0 0 0 0 0 0 0
0 0 0 0 0 0 0 0 0 0 0
0 0 0 0 0 0 0 0 0 0 0
0 0 0 0 0 0 0 0 0 0 0
0 0 0 0 0 0 0 0 0 0 0
0 0 0 0 0 0 0 0 0 0 0
0 0 0 0 0 0 0 0 0 0 0
0 0 0 0 0 0 0 0 0 0 0
0 0 0 0 0 0 0 0 0 0 0
0 0 0 0 0 0 0 0 0 0 0
0 0 0 0 0 0 0 0 0 0 0
0 0 0 0 0 0 0 0 0 0 0
0 0 0 0 0 0 0 0 0 0 0
0 0 0 0 0 0 0 0 0 0 0
0 0 0 0 0 0 0 0 0 0 0
0 0 0 0 0 0 0 0 0 0 0
0 0 0 0 0 0 0 0 0 0 0
0 0 0 0 0 0 0 0 0 0 0
0 0 0 0 0 0 0 0 0 0 0
0 0 0 0 0 0 0 0 0 0 0
0 0 0 0 0 0 0 0 0 0 0
0 0 0 0 0 0 0 0 0 0 0
0 0 0 0 0 0 0 0 0 0 0
0 0 0 0 0 0 0 0 0 0 0
0 0 0 0 0 0 0 0 0 0 0
0 0 0 0 0 0 0 0 0 0 0
0 0 0 0 0 0 0 0 0 0 0
0 0 0 0 0 0 0 0 0 0 0
0 0 0 0 0 0 0 0 0 0 0
0 0 0 0 0 0 0 0 0 0 0
0 0 0 0 0 0 0 0 0 0 0
0 0 0 0 0 0 0 0 0 0 0
0 0 0 0 0 0 0 0 0 0 0
0 0 0 0 0 0 0 0 0 0 0
0 0 0 0 0 0 0 0 0 0 0
0 0 0 0 0 0 0 0 0 0 0
0 0 0 0 0 0 0 0 0 0 0
0 0 0 0 0 0 0 0 0 0 0
0 0 0 0 0 0 0 0 0 0 0
0 0 0 0 0 0 0 0 0 0 0
0 0 0 0 0 0 0 0 0 0 0
0 0 0 0 0 0 0 0 0 0 0
0 0 0 0 0 0 0 0 0 0 0